Rk,Player,Class,Season,Pos,School,Conf,G,MP,FG,FGA,twoP,twoPA,threeP,threePA,FT,FTA,ORB,DRB,TRB,AST,STL,BLK,TOV,PF,PTS
1,Tyler Haws,SR,2014-15,G,Brigham Young,WCC,35,1125,258,538,204,391,54,147,206,236,46,110,156,83,33,9,69,48,776
2,Joseph Young,SR,2014-15,G,Oregon,Pac-12,36,1322,265,592,174,337,91,255,124,134,19,141,160,135,41,1,87,51,745
3,Tyler Harvey,JR,2014-15,G,Eastern Washington,Big Sky,32,1182,230,490,102,193,128,297,150,176,20,96,116,82,36,4,64,60,738
4,Frank Kaminsky,SR,2014-15,C,Wisconsin,Big Ten,39,1311,267,488,225,387,42,101,156,200,58,262,320,103,33,57,63,65,732
5,Chasson Randle,SR,2014-15,G,Stanford,Pac-12,37,1347,217,539,127,291,90,248,200,228,11,112,123,112,50,5,75,82,724
6,D.J. Balentine,JR,2014-15,G,Evansville,MVC,36,1318,245,563,171,374,74,189,159,212,18,96,114,116,29,7,78,35,723
7,Zeek Woodley,SO,2014-15,G,Northwestern State,Southland,32,1009,262,468,223,370,39,98,148,182,55,105,160,34,33,22,38,73,711
8,Ty Greene,SR,2014-15,G,South Carolina Upstate,A-Sun,35,1191,232,522,129,269,103,253,142,189,30,78,108,74,74,7,45,56,709
9,Cameron Payne,SO,2014-15,G,Murray State,OVC,35,1127,245,537,161,314,84,223,133,169,21,108,129,209,68,17,87,72,707
10,D.J. Newbill,SR,2014-15,G,Penn State,Big Ten,34,1261,243,540,182,375,61,165,157,207,37,123,160,105,44,7,90,73,704
11,R.J. Hunter,JR,2014-15,G,Georgia State,Sun Belt,35,1294,203,514,123,252,80,262,202,230,27,138,165,126,75,35,77,85,688
12,A.J. English,JR,2014-15,G,Iona,MAAC,34,1272,212,491,106,217,106,274,155,197,26,148,174,172,49,18,128,91,685
13,D'Angelo Russell,FR,2014-15,G,Ohio State,Big Ten,35,1188,231,515,136,284,95,231,118,156,35,163,198,175,55,11,102,74,675
14,David Laury,SR,2014-15,F,Iona,MAAC,34,1201,244,514,217,443,27,71,159,233,85,244,329,96,27,45,101,92,674
15,Amere May,SR,2014-15,G,Delaware State,MEAC,32,1095,227,543,138,313,89,230,128,156,32,101,133,85,32,6,93,57,671
16,LaDontae Henton,SR,2014-15,F,Providence,Big East,34,1257,230,516,166,327,64,189,145,191,60,162,222,29,46,16,68,76,669
17,Saah Nimley,SR,2014-15,G,Charleston Southern,Big South,31,1106,183,477,73,170,110,307,187,228,17,110,127,126,28,1,85,68,663
18,Marcus Thornton,SR,2014-15,G,William &amp; Mary,CAA,33,1210,215,472,113,218,102,254,127,153,9,83,92,95,21,4,77,36,659
19,Jahlil Okafor,FR,2014-15,C,Duke,ACC,38,1143,279,420,279,420,0,0,99,194,134,188,322,49,29,54,95,81,657
20,K.T. Harrell,SR,2014-15,G,Auburn,SEC,35,1156,194,428,96,202,98,226,162,199,32,72,104,52,33,2,86,80,648
21,Jeffrey Short,JR,2014-15,G,Norfolk State,MEAC,34,1153,212,426,143,251,69,175,155,189,24,118,142,66,32,14,96,63,648
22,Jerome Hill,JR,2014-15,F,Gardner-Webb,Big South,34,1126,211,446,205,408,6,38,216,344,118,227,345,75,18,23,101,76,644
23,Jalan West,JR,2014-15,G,Northwestern State,Southland,32,1104,193,423,107,219,86,204,169,196,18,122,140,246,66,11,90,63,641
24,Kyle Wiltjer,JR,2014-15,F,Gonzaga,WCC,38,1049,242,448,174,302,68,146,86,109,51,184,235,71,18,25,43,62,638
25,Bobby Portis,SO,2014-15,F,Arkansas,SEC,36,1076,250,466,236,436,14,30,115,156,133,188,321,42,39,50,56,78,629
26,Jerian Grant,SR,2014-15,G,Notre Dame,ACC,38,1408,204,427,154,269,50,158,170,218,13,102,115,253,63,19,82,75,628
27,Olivier Hanlan,JR,2014-15,G,Boston College,ACC,32,1204,225,496,160,312,65,184,110,145,24,111,135,135,41,1,85,68,625
28,Lawrence Alexander,SR,2014-15,G,North Dakota State,Summit,33,1271,203,472,99,236,104,236,114,141,14,136,150,56,29,7,65,45,624
29,Denzel Livingston,SR,2014-15,G,Incarnate Word,Southland,29,1071,190,418,144,284,46,134,198,246,43,129,172,85,74,38,80,86,624
30,Obi Emegano,JR,2014-15,G,Oral Roberts,Summit,34,1168,194,434,165,359,29,75,205,260,26,134,160,76,57,6,87,70,622
31,Derrick Marks,SR,2014-15,G,Boise State,MWC,32,998,231,468,163,312,68,156,91,118,16,102,118,96,59,14,68,72,621
32,John Brown,JR,2014-15,F,High Point,Big South,32,995,242,440,242,434,0,6,133,176,101,91,192,39,39,33,53,66,617
33,Terry Rozier,SO,2014-15,G,Louisville,ACC,36,1260,214,521,166,364,48,157,139,176,43,157,200,108,72,6,79,62,615
34,Keifer Sykes,SR,2014-15,G,Green Bay,Horizon,33,1156,213,471,167,323,46,148,142,182,25,123,148,129,55,5,71,72,614
35,Mikh McKinney,SR,2014-15,G,Sacramento State,Big Sky,32,1183,219,432,154,281,65,151,110,137,16,75,91,156,78,4,68,57,613
36,Buddy Hield,JR,2014-15,G,Oklahoma,Big 12,35,1135,205,498,112,239,93,259,107,130,56,134,190,67,47,8,68,61,610
37,James Sinclair,SR,2014-15,G,Western Carolina,Southern,31,1180,214,532,163,370,51,162,122,159,58,129,187,90,67,14,76,65,601
38,Quinn Cook,SR,2014-15,G,Duke,ACC,39,1396,199,439,97,181,102,258,98,110,15,116,131,103,39,1,47,76,598
39,Kahlil Felder,SO,2014-15,G,Oakland,Horizon,33,1272,183,434,136,295,47,139,185,224,25,133,158,252,66,8,137,83,598
40,Travis Trice,SR,2014-15,G,Michigan State,Big Ten,39,1309,195,491,105,247,90,244,118,165,18,105,123,197,40,6,69,70,598
41,Chavaughn Lewis,SR,2014-15,G-F,Marist,MAAC,29,1034,203,491,162,349,41,142,149,224,26,129,155,78,67,22,104,71,596
42,Andrew Rowsey,SO,2014-15,G,North Carolina-Asheville,Big South,31,1010,177,449,75,182,102,267,140,152,19,67,86,89,44,2,70,67,596
43,Corey Walden,SR,2014-15,G,Eastern Kentucky,OVC,32,1108,198,362,147,222,51,140,147,180,27,100,127,123,99,5,71,79,594
44,Keon Moore,SR,2014-15,G,Winthrop,Big South,32,1058,188,424,87,190,101,234,116,135,25,141,166,56,44,8,59,62,593
45,Ryan Boatright,SR,2014-15,G,Connecticut,AAC,34,1216,182,430,96,221,86,209,142,167,15,124,139,129,46,8,81,64,592
46,Trey Freeman,JR,2014-15,G,Old Dominion,CUSA,35,1131,221,502,174,370,47,132,102,140,20,132,152,125,46,4,59,54,591
47,Norman Powell,SR,2014-15,G,UCLA,Pac-12,36,1244,213,467,175,348,38,119,127,169,21,148,169,75,66,16,80,91,591
48,Brad Waldow,SR,2014-15,F,Saint Mary's (CA),WCC,31,1068,235,421,235,421,0,0,120,182,90,193,283,69,16,23,66,73,590
49,Jalen Riley,SR,2014-15,G,East Tennessee State,Southern,29,798,165,426,85,212,80,214,177,214,12,54,66,77,49,2,82,95,587
50,Corey Hawkins,SR,2014-15,G,California-Davis,Big West,28,934,188,374,107,208,81,166,129,157,19,119,138,94,39,6,84,53,586
51,Raven Lee,SO,2014-15,G,Eastern Michigan,MAC,35,981,190,429,120,235,70,194,136,171,25,42,67,54,50,7,101,78,586
52,Juan'ya Green,JR,2014-15,G,Hofstra,CAA,34,1238,158,414,97,232,61,182,203,246,18,128,146,220,48,9,86,73,580
53,Justin Moss,JR,2014-15,F,Buffalo,MAC,33,991,203,390,203,386,0,4,173,237,91,211,302,21,32,25,73,98,579
54,Jordan Sibert,SR,2014-15,G,Dayton,A-10,36,1215,177,388,97,159,80,229,145,184,8,110,118,71,62,5,65,73,579
55,Damion Lee,JR,2014-15,G,Drexel,CAA,27,1029,170,388,105,219,65,169,173,195,24,141,165,63,41,9,50,60,578
56,Damon Lynn,SO,2014-15,G,NJIT,Ind,33,1203,182,499,56,149,126,350,88,114,15,83,98,123,58,2,92,67,578
57,D'Angelo Harrison,SR,2014-15,G,St. John's (NY),Big East,33,1150,178,429,112,250,66,179,155,194,38,143,181,64,37,14,55,114,577
58,Martez Harrison,SO,2014-15,G,Missouri-Kansas City,WAC,33,1057,176,448,129,280,47,168,178,238,19,60,79,129,60,0,86,89,577
59,Dyami Starks,SR,2014-15,G,Bryant,NEC,31,1183,187,496,89,210,98,286,105,115,16,89,105,47,27,7,66,60,577
60,Isiah Umipig,SR,2014-15,G,Seattle,WAC,34,1155,178,440,55,146,123,294,98,116,12,95,107,98,45,0,73,73,577
61,Juwan Howard,SR,2014-15,F,Detroit Mercy,Horizon,33,1042,208,479,144,322,64,157,96,113,35,100,135,78,31,10,69,67,576
62,Kendall Anthony,SR,2014-15,G,Richmond,A-10,35,1276,203,455,143,302,60,153,109,138,10,53,63,89,33,1,54,74,575
63,Jameel Warney,JR,2014-15,F,Stony Brook,AEC,35,1156,243,452,243,452,0,0,89,155,150,259,409,72,26,87,59,74,575
64,Michael Qualls,JR,2014-15,G,Arkansas,SEC,36,1086,180,413,125,248,55,165,158,204,59,133,192,60,32,17,61,62,573
65,Alec Peters,SO,2014-15,F,Valparaiso,Horizon,34,1039,195,399,112,221,83,178,97,117,64,163,227,42,24,11,49,67,570
66,Dan Trist,SR,2014-15,F,Lafayette,Patriot,33,892,230,399,230,399,0,0,110,141,76,146,222,43,12,23,75,71,570
67,Dennis Mavin,SR,2014-15,G,Florida International,CUSA,33,1174,198,452,167,353,31,99,142,221,27,147,174,103,41,1,118,47,569
68,Jordan Price,SO,2014-15,G,La Salle,A-10,33,1054,180,465,111,262,69,203,139,174,16,113,129,75,27,8,103,94,568
69,Melo Trimble,FR,2014-15,G,Maryland,Big Ten,35,1173,150,338,89,190,61,148,207,240,6,129,135,106,44,2,86,65,568
70,Denzel Valentine,JR,2014-15,G,Michigan State,Big Ten,39,1295,197,445,95,200,102,245,71,86,46,199,245,167,35,9,92,85,567
71,Jalen Cannon,SR,2014-15,F,St. Francis (NY),NEC,35,1184,210,404,183,323,27,81,117,168,139,228,367,34,24,27,58,60,564
72,Terran Petteway,JR,2014-15,G-F,Nebraska,Big Ten,31,1086,184,465,116,248,68,217,128,180,17,136,153,87,35,27,104,94,564
73,Tyrone Wallace,JR,2014-15,G,California,Pac-12,33,1152,208,489,180,401,28,88,120,198,30,205,235,131,42,11,94,91,564
74,Stefan Moody,JR,2014-15,G,Mississippi,SEC,34,975,168,433,90,211,78,222,149,165,31,85,116,80,57,3,68,88,563
75,Jordan Gregory,SR,2014-15,G,Montana,Big Sky,33,1189,176,437,89,209,87,228,123,154,18,93,111,107,20,1,70,53,562
76,Kellen Dunham,JR,2014-15,G,Butler,Big East,34,1153,171,399,94,211,77,188,142,167,18,69,87,31,19,1,51,47,561
77,Shawn Long,JR,2014-15,F,Louisiana-Lafayette,Sun Belt,34,951,205,378,177,301,28,77,120,182,103,243,346,50,22,56,78,106,558
78,Jarell Martin,SO,2014-15,F,Louisiana State,SEC,33,1159,202,397,188,345,14,52,140,203,98,207,305,59,38,23,92,92,558
79,Aaron White,SR,2014-15,F,Iowa,Big Ten,34,1070,171,328,150,269,21,59,195,238,71,177,248,48,45,16,41,53,558
80,Sam Dekker,JR,2014-15,F,Wisconsin,Big Ten,40,1239,213,406,163,255,50,151,80,113,77,143,220,49,21,18,36,42,556
81,Yogi Ferrell,JR,2014-15,G,Indiana,Big Ten,34,1186,181,412,99,215,82,197,111,129,21,89,110,166,24,1,65,59,555
82,Bryce Alford,SO,2014-15,G,UCLA,Pac-12,36,1307,171,432,78,194,93,238,119,142,6,108,114,176,34,1,89,54,554
83,Dallas Moore,SO,2014-15,G,North Florida,A-Sun,35,1139,211,439,150,282,61,157,71,97,33,78,111,128,35,1,82,42,554
84,Trevor Lacey,JR,2014-15,G,North Carolina State,ACC,35,1256,190,436,112,237,78,199,93,126,27,133,160,121,31,7,67,56,551
85,Ameen Tanksley,JR,2014-15,G,Hofstra,CAA,34,1105,180,402,106,216,74,186,117,169,60,128,188,49,48,8,68,82,551
86,DeAndre Bembry,SO,2014-15,F,Saint Joseph's,A-10,31,1197,199,461,149,308,50,153,102,160,49,191,240,111,60,29,89,73,550
87,Craig Bradshaw,JR,2014-15,G,Belmont,OVC,30,950,197,401,115,207,82,194,74,99,14,101,115,94,48,11,93,62,550
88,Sheldon McClellan,JR,2014-15,G,Miami (FL),ACC,38,1278,192,397,138,246,54,151,112,136,32,146,178,74,34,7,49,59,550
89,Jarvis Williams,SR,2014-15,F,Murray State,OVC,35,1085,199,351,199,350,0,1,152,228,135,158,293,32,26,35,48,95,550
90,Montrezl Harrell,JR,2014-15,F,Louisville,ACC,35,1229,213,376,204,339,9,37,114,191,111,210,321,49,33,42,69,74,549
91,Zaid Hearst,SR,2014-15,G,Quinnipiac,MAAC,30,1106,197,456,157,312,40,144,115,149,69,113,182,76,15,10,67,66,549
92,Quinton Upshur,SR,2014-15,G,Northern Arizona,Big Sky,38,1131,172,454,90,207,82,247,123,165,20,110,130,44,33,41,48,106,549
93,Tylor Ongwae,SR,2014-15,F,Louisiana-Monroe,Sun Belt,38,1347,198,485,173,382,25,103,127,152,93,159,252,110,37,11,93,82,548
94,Anthony Brown,SR,2014-15,G-F,Stanford,Pac-12,37,1320,176,408,97,229,79,179,116,146,42,214,256,94,28,7,72,78,547
95,Jelani Hewitt,SR,2014-15,G,Georgia Southern,Sun Belt,31,1087,149,424,60,158,89,266,159,197,31,99,130,114,77,10,80,57,546
96,T.J. Price,SR,2014-15,G,Western Kentucky,CUSA,32,1069,175,395,94,199,81,196,115,141,21,150,171,127,30,2,82,86,546
97,Rodney Pryor,JR,2014-15,G,Robert Morris,NEC,35,1028,201,418,120,229,81,189,63,84,41,123,164,62,41,11,50,79,546
98,Chris Hass,JR,2014-15,G,Bucknell,Patriot,34,1007,181,423,99,215,82,208,99,119,20,93,113,38,17,11,51,58,543
99,Rakeem Christmas,SR,2014-15,F,Syracuse,ACC,31,1064,203,368,203,367,0,1,136,191,97,185,282,47,29,78,78,105,542
100,E.C. Matthews,SO,2014-15,G,Rhode Island,A-10,32,1052,172,420,104,211,68,209,130,177,34,112,146,63,24,17,115,68,542
101,Ashton Moore,SR,2014-15,G,Citadel,Southern,30,1129,173,420,94,214,79,206,116,135,15,82,97,109,29,5,102,44,541
102,Julius Brown,SR,2014-15,G,Toledo,MAC,33,1098,193,416,125,246,68,170,84,98,10,63,73,144,31,11,74,44,538
103,Raheem Appleby,SR,2014-15,G,Louisiana Tech,CUSA,36,1184,200,500,129,284,71,216,66,86,22,75,97,73,46,2,39,35,537
104,Mike Caffey,SR,2014-15,G,Long Beach State,Big West,33,1073,195,449,133,274,62,175,83,114,21,110,131,119,61,5,88,65,535
105,Stephen Croone,JR,2014-15,G,Furman,Southern,31,992,155,346,100,188,55,158,170,226,26,119,145,80,51,6,75,78,535
106,Desharick Guidry,SR,2014-15,F,McNeese State,Southland,31,1092,195,400,158,301,37,99,108,151,135,211,346,51,40,20,66,86,535
107,Martin Breunig,JR,2014-15,F,Montana,Big Sky,32,963,214,361,212,348,2,13,104,141,82,151,233,60,17,27,76,110,534
108,Matt Mobley,SO,2014-15,G,Central Connecticut State,NEC,31,1147,171,428,97,221,74,207,118,156,15,71,86,57,26,6,83,64,534
109,Marcus Paige,JR,2014-15,G,North Carolina,ACC,38,1263,172,416,78,178,94,238,96,111,14,96,110,170,65,8,73,62,534
110,Quincy Taylor,SR,2014-15,G,Longwood,Big South,31,1115,188,433,102,254,86,179,72,98,13,79,92,83,40,5,93,74,534
111,Seth Tuttle,SR,2014-15,F,Northern Iowa,MVC,35,1062,183,303,164,259,19,44,149,195,47,193,240,114,33,20,99,75,534
112,Treveon Graham,SR,2014-15,G,Virginia Commonwealth,A-10,33,970,172,402,108,234,64,168,125,181,73,162,235,53,20,9,38,67,533
113,Tyler Kalinoski,SR,2014-15,G,Davidson,A-10,32,1112,191,410,100,195,91,215,60,76,48,133,181,130,39,13,44,85,533
114,Askia Booker,SR,2014-15,G,Colorado,Pac-12,31,936,173,447,118,280,55,167,131,157,15,88,103,99,44,2,70,56,532
115,Chris Hansen,SR,2014-15,G-F,Idaho State,Big Sky,30,998,157,389,77,180,80,209,138,165,11,90,101,70,39,0,59,45,532
116,Johnathan Jordan,SR,2014-15,G,Texas A&amp;M-Corpus Christi,Southland,34,1219,167,373,155,331,12,42,186,283,28,104,132,178,63,3,88,71,532
117,Le'Bryan Nash,JR,2014-15,G-F,Oklahoma State,Big 12,31,982,178,385,176,365,2,20,174,220,37,139,176,62,24,29,100,92,532
118,Anthony Beane,JR,2014-15,G,Southern Illinois,MVC,33,1148,187,442,139,298,48,144,109,134,18,69,87,36,41,10,59,72,531
119,Will Cummings,SR,2014-15,G,Temple,AAC,36,1224,159,396,135,291,24,105,189,234,33,114,147,151,67,7,71,86,531
120,Alex Hamilton,JR,2014-15,G,Louisiana Tech,CUSA,36,1099,170,395,136,276,34,119,156,208,28,91,119,94,62,9,76,63,530
121,Ryan Harrow,SR,2014-15,G,Georgia State,Sun Belt,29,923,208,413,165,304,43,109,71,99,11,49,60,104,42,3,55,43,530
122,Ike Nwamu,JR,2014-15,G,Mercer,Southern,35,1163,171,400,91,186,80,214,108,142,24,91,115,56,26,14,75,62,530
123,Marcquise Reed,FR,2014-15,G,Robert Morris,NEC,35,973,197,402,164,322,33,80,102,131,20,68,88,73,67,1,90,72,529
124,Thomas Walkup,JR,2014-15,G,Stephen F. Austin,Southland,34,943,185,326,174,284,11,42,148,199,84,136,220,126,40,6,73,100,529
125,Johnny Dee,SR,2014-15,G,San Diego,WCC,31,965,167,390,87,179,80,211,113,123,11,96,107,40,36,2,32,45,527
126,Marvelle Harris,JR,2014-15,G,Fresno State,MWC,32,1168,174,402,121,237,53,165,125,169,23,138,161,120,65,8,85,96,526
127,Javonte Green,SR,2014-15,F,Radford,Big South,34,891,185,340,184,331,1,9,154,221,97,210,307,43,65,29,69,85,525
128,DaVonte Lacy,SR,2014-15,G,Washington State,Pac-12,31,1005,158,389,90,183,68,206,141,183,22,59,81,66,20,4,56,68,525
129,Josh Williams,SO,2014-15,G,Lipscomb,A-Sun,31,978,177,369,108,193,69,176,101,138,50,102,152,61,42,5,72,87,524
130,Emmy Andujar,SR,2014-15,F,Manhattan,MAAC,32,1019,192,375,188,359,4,16,135,192,86,157,243,111,65,7,131,93,523
131,Janari Joesaar,SO,2014-15,F,Texas-Pan American,WAC,31,1053,157,341,95,177,62,164,147,180,67,139,206,75,39,18,86,80,523
132,Stanley Johnson,FR,2014-15,F,Arizona,Pac-12,38,1081,174,390,131,274,43,116,132,178,75,172,247,63,57,15,82,100,523
133,Trey Lewis,JR,2014-15,G,Cleveland State,Horizon,33,1172,176,403,89,187,87,216,84,111,26,118,144,92,40,5,76,65,523
134,Levi Randolph,SR,2014-15,G,Alabama,SEC,34,1200,169,351,130,239,39,112,146,174,32,142,174,84,50,6,48,72,523
135,D'Vauntes Smith-Rivera,JR,2014-15,G,Georgetown,Big East,32,1102,157,373,85,187,72,186,136,158,26,108,134,101,51,6,52,67,522
136,Georges Niang,JR,2014-15,F,Iowa State,Big 12,34,1045,187,406,141,291,46,115,101,125,35,149,184,117,17,16,91,96,521
137,David Brown,SR,2014-15,G,Western Michigan,MAC,34,1119,165,389,80,152,85,237,105,143,13,103,116,73,45,4,63,94,520
138,Mike Myers,SR,2014-15,F,Maryland-Eastern Shore,MEAC,33,871,169,285,168,279,1,6,181,282,87,145,232,45,39,12,105,111,520
139,Ken Williams,SO,2014-15,G,South Alabama,Sun Belt,33,1087,165,439,78,204,87,235,102,129,13,108,121,80,24,9,76,66,519
140,Christian Wood,SO,2014-15,F,Nevada-Las Vegas,MWC,33,1078,187,376,162,288,25,88,120,163,94,235,329,43,11,90,79,86,519
141,J.J. Avila,SR,2014-15,F,Colorado State,MWC,31,995,206,373,197,336,9,37,97,153,91,140,231,88,62,11,84,81,518
142,James Blackmon,FR,2014-15,G,Indiana,Big Ten,33,989,177,421,100,222,77,199,87,108,53,123,176,50,21,2,53,51,518
143,Chris Fowler,JR,2014-15,G,Central Michigan,MAC,32,1093,183,361,163,295,20,66,132,194,16,83,99,194,49,7,91,77,518
144,Venky Jois,JR,2014-15,F,Eastern Washington,Big Sky,31,966,210,344,207,334,3,10,95,176,82,156,238,63,37,69,71,75,518
145,Marcus Posley,JR,2014-15,G,St. Bonaventure,A-10,31,1114,170,445,94,209,76,236,101,129,14,77,91,66,38,1,64,71,517
146,Ron Baker,JR,2014-15,G,Wichita State,MVC,35,1145,171,395,91,186,80,209,94,124,31,126,157,88,45,27,39,60,516
147,Maodo Lo,JR,2014-15,G,Columbia,Ivy,28,957,181,370,97,175,84,195,70,91,13,109,122,65,43,16,69,62,516
148,Jordan Downing,SR,2014-15,G,Presbyterian,Big South,31,1007,184,445,115,251,69,194,78,102,21,112,133,36,19,5,63,67,515
149,Kris Dunn,SO,2014-15,G,Providence,Big East,33,1123,185,390,158,313,27,77,118,172,28,152,180,247,90,10,138,101,515
150,Jordan Parks,SR,2014-15,G,North Carolina Central,MEAC,33,1042,212,321,206,305,6,16,84,126,87,186,273,22,35,31,61,98,514
151,Scott Eatherton,SR,2014-15,F,Northeastern,CAA,35,1054,197,333,189,302,8,31,111,160,63,161,224,53,19,43,71,92,513
152,Josh Richardson,SR,2014-15,G,Tennessee,SEC,32,1162,184,399,138,271,46,128,99,124,28,115,143,115,67,16,85,79,513
153,Stephan Hicks,SR,2014-15,G-F,Cal State Northridge,Big West,32,1072,167,333,151,293,16,40,161,198,61,112,173,46,30,15,60,75,511
154,Karl Cochran,SR,2014-15,G,Wofford,Southern,35,1091,182,468,84,200,98,268,48,74,29,176,205,94,63,36,57,67,510
155,Kris Yanku,SO,2014-15,G,Northern Arizona,Big Sky,37,1111,130,393,110,325,20,68,230,289,22,143,165,189,43,1,115,94,510
156,Jared Brownridge,SO,2014-15,G,Santa Clara,WCC,32,1079,161,365,68,150,93,215,94,109,12,80,92,81,34,4,47,58,509
157,Delon Wright,SR,2014-15,G,Utah,Pac-12,35,1165,165,324,139,251,26,73,153,183,34,139,173,178,73,34,68,49,509
158,Earl Brown,SR,2014-15,F,Saint Francis (PA),NEC,32,1133,188,349,171,297,17,52,115,169,74,181,255,61,34,31,106,59,508
159,Marcus Burton,SR,2014-15,G,Wagner,NEC,29,979,174,434,113,244,61,190,99,122,15,62,77,46,33,0,66,57,508
160,Schadrac Casimir,FR,2014-15,G,Iona,MAAC,35,1201,156,365,62,143,94,222,102,114,19,79,98,69,39,2,41,77,508
161,Kyle Wilson,JR,2014-15,G-F,Army,Patriot,29,939,171,445,97,226,74,219,92,117,14,69,83,54,23,3,77,51,508
162,Brandon Clark,SR,2014-15,G,Santa Clara,WCC,32,1045,163,434,113,257,50,177,131,153,12,106,118,124,28,0,68,84,507
163,Shannon Evans,SO,2014-15,G,Buffalo,MAC,33,1139,163,395,97,222,66,173,115,144,15,89,104,153,56,10,84,69,507
164,Marcus Gilbert,JR,2014-15,F,Fairfield,MAAC,31,1075,154,348,98,177,56,171,143,184,49,124,173,38,25,19,67,70,507
165,Damian Jones,SO,2014-15,C,Vanderbilt,SEC,35,1020,186,331,185,326,1,5,133,222,76,151,227,26,20,70,76,89,506
166,Shonn Miller,SR,2014-15,F,Cornell,Ivy,30,940,168,387,140,283,28,104,141,169,28,226,254,30,38,54,53,86,505
167,Jermaine Ruttley,JR,2014-15,G,Florida A&amp;M,MEAC,29,956,181,401,148,289,33,112,110,162,40,154,194,62,46,2,69,88,505
168,Taylor Johns,JR,2014-15,F,California-Riverside,Big West,31,1067,191,411,182,373,9,38,113,177,80,175,255,59,37,52,106,91,504
169,Carson Puriefoy,JR,2014-15,G,Stony Brook,AEC,35,1158,161,423,110,255,51,168,131,173,16,95,111,118,40,10,98,74,504
170,Daishon Knight,SR,2014-15,G,Illinois State,MVC,35,1046,178,405,133,282,45,123,101,117,26,89,115,85,36,1,63,41,502
171,Stacy Davis,JR,2014-15,F,Pepperdine,WCC,32,1025,165,349,150,297,15,52,156,193,75,173,248,59,30,35,87,74,501
172,Darrun Hilliard,SR,2014-15,G,Villanova,Big East,35,1007,170,386,91,182,79,204,82,103,16,93,109,74,63,12,42,78,501
173,Ladarius Tabb,JR,2014-15,G-F,Alabama A&amp;M,SWAC,28,926,190,421,144,262,46,159,75,124,91,126,217,20,35,4,49,80,501
174,James Daniel,SO,2014-15,G-F,Howard,MEAC,30,972,140,414,72,176,68,238,152,186,15,50,65,81,55,0,108,56,500
175,Marcus Keene,SO,2014-15,G,Youngstown State,Horizon,32,1117,167,372,76,155,91,217,74,94,13,100,113,88,35,3,68,80,499
176,Wesley Saunders,SR,2014-15,G-F,Harvard,Ivy,30,1032,164,362,133,289,31,73,140,181,51,131,182,128,55,11,78,66,499
177,Eric Stutz,SR,2014-15,F,Eastern Kentucky,OVC,32,1025,190,312,165,259,25,53,94,118,61,121,182,76,27,21,68,57,499
178,Larry Nance,SR,2014-15,F,Wyoming,MWC,31,1082,185,360,171,318,14,42,114,145,44,180,224,76,37,37,70,69,498
179,Nigel Hayes,SO,2014-15,F,Wisconsin,Big Ten,40,1319,166,334,126,233,40,101,125,168,85,162,247,79,34,16,51,76,497
180,Rashid Gaston,JR,2014-15,F,Norfolk State,MEAC,32,983,204,326,204,326,0,0,88,162,106,200,306,45,8,37,66,89,496
181,Stefan Nastic,SR,2014-15,C,Stanford,Pac-12,37,1098,179,379,179,379,0,0,138,183,90,149,239,53,13,38,75,137,496
182,James Carlton,SR,2014-15,G-F,Howard,MEAC,31,980,181,384,161,305,20,79,112,148,59,183,242,31,31,32,84,87,494
183,Brent Jones,SR,2014-15,G,St. Francis (NY),NEC,35,1188,157,396,107,244,50,152,129,167,28,91,119,184,66,3,120,68,493
184,Nic Moore,JR,2014-15,G,Southern Methodist,AAC,34,1179,156,371,79,186,77,185,104,117,8,70,78,175,43,1,87,64,493
185,James Woodard,JR,2014-15,G,Tulsa,AAC,34,1174,158,388,70,150,88,238,89,126,18,149,167,38,30,8,46,55,493
186,Robert Brown,JR,2014-15,G,Alabama-Birmingham,CUSA,36,1165,176,438,115,251,61,187,79,107,29,103,132,109,37,9,75,62,492
187,Vince Hunter,SO,2014-15,F,Texas-El Paso,CUSA,33,940,182,346,178,336,4,10,124,206,88,217,305,55,41,34,92,98,492
188,Brice Johnson,JR,2014-15,F,North Carolina,ACC,38,940,207,366,207,366,0,0,78,115,89,206,295,35,26,42,58,112,492
189,Justise Winslow,FR,2014-15,F,Duke,ACC,39,1135,173,356,127,246,46,110,100,156,49,203,252,82,52,34,71,108,492
190,Connor Hill,SR,2014-15,G,Idaho,Big Sky,30,921,164,365,56,125,108,240,55,65,15,53,68,20,15,0,30,56,491
191,Deondre Parks,JR,2014-15,G,South Dakota State,Summit,35,1113,167,391,98,201,69,190,88,117,17,125,142,67,22,3,62,85,491
192,C.J. Carter,SR,2014-15,G,Nebraska-Omaha,Summit,29,995,176,388,128,239,48,149,90,127,13,54,67,78,43,19,85,70,490
193,LeAntwan Luckett,JR,2014-15,F,Alcorn State,SWAC,30,1031,158,424,111,272,47,152,127,181,52,51,103,52,40,13,68,86,490
194,Marcel Mosley,SR,2014-15,G,Arkansas-Pine Bluff,SWAC,28,997,145,360,76,179,69,181,130,159,23,58,81,73,58,0,97,53,489
195,Seth Gearhart,SR,2014-15,F,Rice,CUSA,32,1084,143,324,74,151,69,173,133,163,36,134,170,58,31,12,71,89,488
196,Cody Larson,JR,2014-15,F,South Dakota State,Summit,35,999,172,346,169,337,3,9,140,191,71,181,252,64,22,37,65,102,487
197,Yonel Brown,JR,2014-15,G,Kennesaw State,A-Sun,32,1184,144,350,81,185,63,165,135,150,14,60,74,89,38,0,80,55,486
198,Tyrell Nelson,SO,2014-15,C,Gardner-Webb,Big South,35,966,195,320,195,318,0,2,96,152,101,128,229,29,22,29,56,107,486
199,Evan Payne,SO,2014-15,G,Loyola Marymount,WCC,27,764,160,361,123,256,37,105,129,163,21,55,76,45,21,5,63,42,486
200,Damon Sherman-Newsome,SR,2014-15,G,Colgate,Patriot,33,1026,175,380,107,198,68,182,68,100,18,93,111,60,20,5,60,51,486
201,Bruce Beckford,JR,2014-15,F,North Carolina A&amp;T,MEAC,32,1063,167,378,141,281,26,97,125,152,70,163,233,45,28,22,88,85,485
202,Stephen Maxwell,SR,2014-15,F,Cal State Northridge,Big West,33,1111,171,350,171,350,0,0,143,194,108,155,263,19,25,5,67,88,485
203,Frank Eaves,JR,2014-15,G,Appalachian State,Sun Belt,29,959,138,361,76,184,62,177,143,176,33,80,113,49,38,0,73,63,481
204,Phil Forte,JR,2014-15,G,Oklahoma State,Big 12,32,1078,139,328,69,144,70,184,131,156,3,64,67,55,60,2,60,44,479
205,Jeromie Hill,SR,2014-15,F,Texas-San Antonio,CUSA,30,1006,183,433,127,277,56,156,57,93,73,171,244,40,33,20,73,75,479
206,Maurice Ndour,SR,2014-15,F,Ohio,MAC,30,1047,164,339,137,277,27,62,124,158,68,182,250,50,33,68,89,83,479
207,Aaseem Dixon,SR,2014-15,G,Northern Arizona,Big Sky,37,1293,158,435,70,207,88,228,74,95,28,98,126,85,27,1,55,63,478
208,Jordan Mickey,SO,2014-15,F,Louisiana State,SEC,31,1081,191,379,190,370,1,9,95,147,99,209,308,40,29,112,101,81,478
209,Shavon Shields,JR,2014-15,G,Nebraska,Big Ten,31,1095,161,366,144,279,17,87,139,168,45,141,186,67,33,5,84,73,478
210,Zach Auguste,JR,2014-15,F,Notre Dame,ACC,37,904,190,307,190,307,0,0,96,151,82,157,239,29,25,25,61,94,476
211,Malcolm Brogdon,JR,2014-15,G,Virginia,ACC,34,1105,158,374,114,246,44,128,116,132,16,118,134,81,24,14,58,65,476
212,Jimmy Hall,SO,2014-15,F,Kent State,MAC,30,859,193,363,191,358,2,5,88,129,89,142,231,46,15,29,68,96,476
213,Xavier Rathan-Mayes,FR,2014-15,G,Florida State,ACC,32,1110,165,397,117,226,48,171,98,142,16,96,112,137,35,0,108,74,476
214,Pat Connaughton,SR,2014-15,G-F,Notre Dame,ACC,38,1351,166,356,73,136,93,220,50,64,41,241,282,57,27,36,44,75,475
215,Malcolm Hill,SO,2014-15,G,Illinois,Big Ten,33,1010,156,352,114,244,42,108,121,155,61,98,159,44,28,7,49,68,475
216,Fred VanVleet,JR,2014-15,G,Wichita State,MVC,35,1104,151,351,111,239,40,112,133,167,41,115,156,183,66,4,59,50,475
217,Kori Babineaux,JR,2014-15,G,Jacksonville,A-Sun,32,1080,193,396,191,375,2,21,86,145,18,108,126,127,51,4,106,81,474
218,Aaron Brown,SR,2014-15,G,Boston College,ACC,32,1086,158,384,98,194,60,190,98,143,15,84,99,64,19,1,70,65,474
219,Tyler Larson,SR,2014-15,G,South Dakota,Summit,33,1141,156,362,124,276,32,86,130,173,74,185,259,95,26,8,70,85,474
220,Devareaux Manley,SR,2014-15,G,Kent State,MAC,35,1139,144,361,30,74,114,287,72,93,15,84,99,29,20,6,37,64,474
221,Tanner Plomb,JR,2014-15,F,Army,Patriot,30,846,166,391,100,216,66,175,76,94,29,139,168,40,24,12,57,61,474
222,Sterling Gibbs,JR,2014-15,G,Seton Hall,Big East,29,976,151,350,76,178,75,172,96,137,15,45,60,110,35,0,58,45,473
223,Jesse Reed,JR,2014-15,G,American,Patriot,33,1269,158,336,112,207,46,129,111,144,23,141,164,44,33,19,62,75,473
224,Marvin Dominique,SR,2014-15,F,Saint Peter's,MAAC,34,1096,167,362,130,260,37,102,101,135,84,162,246,17,30,22,51,89,472
225,Jacob Parker,SR,2014-15,F,Stephen F. Austin,Southland,34,922,157,307,102,182,55,125,103,123,58,129,187,55,37,14,55,95,472
226,Jaylen Bland,JR,2014-15,G,California-Riverside,Big West,31,1103,151,395,56,150,95,245,74,92,24,124,148,49,43,11,55,59,471
227,Corey Petros,SR,2014-15,C-F,Oakland,Horizon,33,1190,201,334,201,333,0,1,69,149,108,164,272,66,17,10,50,87,471
228,Demetrius Jackson,SO,2014-15,G,Notre Dame,ACC,38,1318,167,329,113,203,54,126,82,110,44,93,137,116,59,12,57,71,470
229,Jalen Moore,SO,2014-15,F,Utah State,MWC,31,1066,157,319,112,204,45,115,111,149,36,173,209,53,19,27,37,44,470
230,Evan Bradds,SO,2014-15,G-F,Belmont,OVC,33,928,185,269,180,256,5,13,94,145,65,171,236,44,21,7,83,74,469
231,Perry Ellis,JR,2014-15,F,Kansas,Big 12,34,978,166,363,148,317,18,46,119,163,74,160,234,42,28,23,58,81,469
232,Deville Smith,SR,2014-15,G,Tennessee-Martin,OVC,34,1220,170,410,109,220,61,190,68,103,18,135,153,153,59,19,102,69,469
233,David Walker,JR,2014-15,G,Northeastern,CAA,35,1298,142,325,73,149,69,176,116,134,10,111,121,126,41,10,78,28,469
234,Elijah Bryant,FR,2014-15,G,Elon,CAA,33,840,147,385,103,259,44,126,130,173,45,93,138,89,42,13,115,87,468
235,Elgin Cook,JR,2014-15,F,Oregon,Pac-12,36,1059,169,325,164,305,5,20,125,171,52,136,188,59,38,6,80,117,468
236,Anton Grady,JR,2014-15,F,Cleveland State,Horizon,33,984,183,379,179,369,4,10,98,151,75,186,261,59,49,45,71,102,468
237,Nigel Williams-Goss,SO,2014-15,G,Washington,Pac-12,30,1104,186,421,164,335,22,86,74,97,20,121,141,177,33,5,85,56,468
238,Jarell Flora,SR,2014-15,G,Seattle,WAC,34,1097,166,383,86,185,80,198,54,66,19,125,144,51,29,9,73,50,466
239,Bobby Hain,JR,2014-15,F,Youngstown State,Horizon,32,1018,181,352,174,321,7,31,97,137,75,163,238,65,18,20,56,82,466
240,Brandon Ashley,JR,2014-15,F,Arizona,Pac-12,38,1055,166,323,154,287,12,36,121,172,69,128,197,25,23,25,55,107,465
241,Marcus Jackson,SO,2014-15,G,Rice,CUSA,32,1013,153,370,68,156,85,214,74,89,25,86,111,87,27,4,74,66,465
242,Codi Miller-McIntyre,JR,2014-15,G,Wake Forest,ACC,32,1007,167,371,148,304,19,67,112,174,27,126,153,137,32,11,80,57,465
243,Andrew Andrews,JR,2014-15,G,Washington,Pac-12,31,1047,140,347,75,174,65,173,119,146,32,100,132,67,44,1,61,81,464
244,Jamel Artis,SO,2014-15,F,Pittsburgh,ACC,34,1082,160,341,121,242,39,99,105,132,67,138,205,77,25,15,60,63,464
245,Cane Broome,FR,2014-15,G,Sacred Heart,NEC,32,1011,165,371,120,238,45,133,88,117,15,107,122,77,36,6,75,63,463
246,Twymond Howard,JR,2014-15,F-G,Tennessee-Martin,OVC,34,1182,167,351,146,290,21,61,106,148,62,161,223,58,29,20,61,85,461
247,Tyus Jones,FR,2014-15,G,Duke,ACC,39,1322,135,324,88,200,47,124,144,162,19,118,137,217,59,3,76,46,461
248,Anthony Livingston,SO,2014-15,F,Arkansas State,Sun Belt,29,1039,166,358,139,274,27,84,102,148,77,214,291,22,14,29,78,67,461
249,Ralston Turner,SR,2014-15,G,North Carolina State,ACC,36,1136,150,381,56,125,94,256,67,80,22,95,117,35,22,6,37,86,461
250,Dylan Garrity,SR,2014-15,G,Sacramento State,Big Sky,33,1085,148,319,67,121,81,198,83,100,8,59,67,84,32,1,55,54,460
251,Cedric Hankerson,SO,2014-15,G,Boston University,Patriot,29,982,121,305,49,124,72,181,146,217,21,110,131,76,52,3,78,85,460
252,Adrian Rodgers,SO,2014-15,G,Southern,SWAC,35,1010,164,420,110,254,54,166,78,98,24,122,146,40,26,5,64,67,460
253,Ron Curry,JR,2014-15,G,James Madison,CAA,33,1175,141,349,79,202,62,147,115,156,19,108,127,143,36,7,75,60,459
254,Tim Kempton,SO,2014-15,C-F,Lehigh,Patriot,30,866,172,345,171,344,1,1,114,160,56,204,260,31,15,11,76,79,459
255,Taurean Prince,JR,2014-15,F,Baylor,Big 12,33,868,167,354,107,202,60,152,65,101,60,124,184,42,49,29,67,70,459
256,Sam Rowley,SR,2014-15,F,Albany (NY),AEC,33,1094,168,332,168,328,0,4,123,150,81,170,251,59,40,26,88,90,459
257,Michael Bryson,JR,2014-15,G,California-Santa Barbara,Big West,33,1060,160,360,92,171,68,189,70,82,33,125,158,56,27,22,51,82,458
258,Chip Armelin,JR,2014-15,G,Southern Mississippi,CUSA,29,1022,170,364,109,195,61,169,56,88,37,83,120,56,33,6,57,42,457
259,Richaun Holmes,SR,2014-15,F,Bowling Green State,MAC,31,892,165,293,147,250,18,43,109,153,88,160,248,26,22,83,60,77,457
260,Dyshawn Pierre,JR,2014-15,F,Dayton,A-10,36,1202,164,354,127,250,37,104,92,136,76,215,291,103,22,15,72,65,457
261,Brandon Bos,SR,2014-15,G,South Dakota,Summit,33,1019,147,398,99,260,48,138,114,138,29,90,119,74,13,2,71,54,456
262,Kyle Collinsworth,JR,2014-15,G,Brigham Young,WCC,33,1019,158,335,152,314,6,21,134,182,81,205,286,197,59,11,96,73,456
263,Quenton DeCosey,JR,2014-15,G,Temple,AAC,37,1109,143,379,92,237,51,142,119,177,37,132,169,81,31,12,66,70,456
264,Andre Hollins,JR,2014-15,G,Minnesota,Big Ten,33,1007,153,366,71,167,82,199,68,90,27,105,132,89,35,6,61,72,456
265,Jordan Howard,FR,2014-15,G,Central Arkansas,Southland,29,978,146,360,69,162,77,198,87,111,6,66,72,56,14,0,77,38,456
266,Zak Irvin,SO,2014-15,G-F,Michigan,Big Ten,32,1160,163,405,86,188,77,217,53,76,31,122,153,49,33,3,47,42,456
267,Jordan Williams,SR,2014-15,G,North Texas,CUSA,31,1062,153,392,112,243,41,149,109,149,42,110,152,64,47,15,83,69,456
268,Warren Gillis,SR,2014-15,G,Coastal Carolina,Big South,34,1064,160,366,134,281,26,85,109,125,22,84,106,108,48,3,88,76,455
269,Josh Hawkinson,SO,2014-15,F,Washington State,Pac-12,31,1015,166,332,159,297,7,35,116,136,65,269,334,30,12,34,32,67,455
270,Addison Spruill,SR,2014-15,G,North Carolina-Wilmington,CAA,32,981,165,371,151,320,14,51,111,152,57,152,209,52,30,16,73,81,455
271,Eric Washington,JR,2014-15,G,Miami (OH),MAC,32,1029,137,304,111,225,26,79,155,195,26,76,102,176,45,1,108,71,455
272,Terry Allen,JR,2014-15,F,Richmond,A-10,35,1093,170,331,154,265,16,66,98,131,56,177,233,47,48,23,67,77,454
273,Jay Harris,SR,2014-15,G,Illinois-Chicago,Horizon,30,974,122,318,71,161,51,157,159,177,19,71,90,110,39,3,84,57,454
274,Casey Jones,SO,2014-15,G,Chattanooga,Southern,32,945,168,324,165,312,3,12,115,162,80,145,225,59,37,37,85,82,454
275,Matt Stainbrook,SR,2014-15,C,Xavier,Big East,37,987,173,282,172,277,1,5,107,140,73,184,257,89,22,24,73,93,454
276,DaShaun Wiggins,SR,2014-15,G,Portland State,Big Sky,29,823,133,322,74,187,59,135,129,176,17,93,110,47,44,2,59,79,454
277,Michael Young,SO,2014-15,F,Pittsburgh,ACC,34,1077,167,315,162,298,5,17,115,166,111,138,249,44,21,28,38,89,454
278,Madarious Gibbs,SR,2014-15,G,Texas Southern,SWAC,32,1234,158,368,135,277,23,91,114,169,20,86,106,135,30,2,92,71,453
279,Beau Beech,JR,2014-15,G,North Florida,A-Sun,35,1065,149,351,60,118,89,233,65,83,36,164,200,50,43,10,64,92,452
280,Frank Mason,SO,2014-15,G,Kansas,Big 12,36,1207,150,340,108,242,42,98,110,140,22,119,141,142,50,4,74,65,452
281,Sir'Dominic Pointer,SR,2014-15,G-F,St. John's (NY),Big East,33,1143,175,334,173,309,2,25,100,138,64,189,253,98,63,80,66,99,452
282,Rashawn Thomas,SO,2014-15,F,Texas A&amp;M-Corpus Christi,Southland,33,913,154,281,154,275,0,6,144,226,95,167,262,34,18,40,103,121,452
283,Aaron Valdes,SO,2014-15,G,Hawaii,Big West,33,934,161,338,130,252,31,86,98,148,62,114,176,40,56,12,56,78,451
284,Shaquille Johnson,JR,2014-15,G-F,Longwood,Big South,33,1065,166,419,135,292,31,127,87,115,61,124,185,94,49,18,114,92,450
285,Ryan Taylor,SO,2014-15,F,Marshall,CUSA,32,920,152,359,124,257,28,102,118,169,60,215,275,90,28,25,88,100,450
286,Josh Adams,JR,2014-15,G,Wyoming,MWC,35,1176,146,334,99,189,47,145,110,148,21,93,114,126,48,8,90,74,449
287,Remi Barry,SR,2014-15,F,New Mexico State,WAC,34,1095,154,337,111,239,43,98,98,128,46,115,161,35,19,6,61,62,449
288,Keon Lewis,SR,2014-15,G,Texas-San Antonio,CUSA,29,974,129,324,94,222,35,102,156,190,19,59,78,89,47,0,62,57,449
289,Alan Williams,SR,2014-15,C,California-Santa Barbara,Big West,26,847,160,349,160,346,0,3,129,168,86,222,308,45,31,47,51,70,449
290,Chase Fischer,JR,2014-15,G,Brigham Young,WCC,34,914,147,351,44,103,103,248,51,65,10,64,74,67,25,2,49,50,448
291,Jordan Mathews,SO,2014-15,G,California,Pac-12,33,1027,143,321,73,163,70,158,92,117,18,95,113,46,20,1,50,64,448
292,Musa Abdul-Aleem,SR,2014-15,G,Troy,Sun Belt,28,811,151,341,81,152,70,189,75,95,25,109,134,20,33,1,53,60,447
293,Javier Duren,SR,2014-15,G,Yale,Ivy,32,1004,132,328,80,185,52,143,131,167,26,150,176,126,41,9,87,80,447
294,Shaquille Harrison,JR,2014-15,G,Tulsa,AAC,34,1069,163,363,150,308,13,55,108,171,40,133,173,125,67,20,81,83,447
295,Melvin Johnson,JR,2014-15,G,Virginia Commonwealth,A-10,36,1003,155,385,69,148,86,237,51,65,17,53,70,65,37,3,36,56,447
296,Montrael Scott,SR,2014-15,G,Prairie View,SWAC,29,993,163,385,110,218,53,167,68,91,28,96,124,51,41,1,65,61,447
297,Mark Tollefsen,JR,2014-15,F,San Francisco,WCC,32,1001,176,329,134,218,42,111,53,82,56,118,174,48,27,27,35,58,447
298,Ousmane Drame,SR,2014-15,F,Quinnipiac,MAAC,30,873,158,347,157,344,1,3,129,160,108,227,335,31,21,88,69,89,446
299,Marshun Newell,SR,2014-15,G,Tennessee-Martin,OVC,34,1199,146,354,77,184,69,170,85,112,52,182,234,91,35,3,75,59,446
300,Kruize Pinkins,SR,2014-15,F,San Francisco,WCC,32,837,154,316,122,234,32,82,106,163,70,106,176,44,22,13,57,99,446
301,Omar Prewitt,SO,2014-15,G-F,William &amp; Mary,CAA,33,1089,152,331,102,184,50,147,91,130,16,128,144,84,40,27,63,77,445
302,Kendall Pollard,SO,2014-15,F,Dayton,A-10,35,1020,159,288,156,279,3,9,123,212,39,148,187,37,30,32,85,116,444
303,Justin Sears,JR,2014-15,F,Yale,Ivy,31,1012,154,301,152,295,2,6,134,194,94,140,234,48,34,73,85,77,444
304,Adam Smith,JR,2014-15,G,Virginia Tech,ACC,33,986,158,361,77,170,81,191,46,62,14,71,85,30,12,4,26,54,443
305,Keith Hornsby,JR,2014-15,G,Louisiana State,SEC,33,1172,156,370,84,187,72,183,58,74,20,118,138,69,37,16,47,52,442
306,Lucky Jones,SR,2014-15,G-F,Robert Morris,NEC,31,924,135,346,75,165,60,181,112,142,43,141,184,43,42,12,73,82,442
307,D'Shon Taylor,JR,2014-15,G,Norfolk State,MEAC,34,1082,145,322,95,181,50,141,102,151,54,116,170,45,28,25,57,93,442
308,Kyan Anderson,SR,2014-15,G,Texas Christian,Big 12,33,1055,132,332,75,164,57,168,120,138,9,39,48,141,41,5,84,68,441
309,Cedric Blossom,JR,2014-15,F,Morgan State,MEAC,31,1077,161,378,159,370,2,8,117,168,100,119,219,22,33,8,37,73,441
310,Mike Brown,JR,2014-15,G,Western Carolina,Southern,32,1117,162,354,120,240,42,114,75,112,67,133,200,51,29,18,70,95,441
311,George Fant,SR,2014-15,F,Western Kentucky,CUSA,32,920,170,321,170,321,0,0,101,163,103,165,268,50,30,21,66,107,441
312,Alex Harris,SR,2014-15,G,Cal State Fullerton,Big West,28,897,147,354,112,231,35,123,112,167,12,99,111,98,41,4,77,54,441
313,Ashton Pankey,JR,2014-15,F,Manhattan,MAAC,33,908,145,274,145,274,0,0,151,217,77,143,220,31,23,47,76,120,441
314,Justin Robinson,SO,2014-15,G,Monmouth,MAAC,33,1062,139,331,87,190,52,141,111,140,21,92,113,120,56,0,64,48,441
315,Will Davis,SR,2014-15,F,California-Irvine,Big West,34,1012,185,341,185,340,0,1,70,99,83,157,240,33,18,34,45,47,440
316,Kevin Pangos,SR,2014-15,G,Gonzaga,WCC,38,1278,135,301,54,113,81,188,89,108,16,88,104,181,48,4,51,74,440
317,Bernard Thompson,SR,2014-15,G,Florida Gulf Coast,A-Sun,32,1031,151,383,77,187,74,196,64,87,46,114,160,56,55,4,50,66,440
318,Jherrod Stiggers,JR,2014-15,G,Houston,AAC,31,1105,139,384,43,104,96,280,65,85,17,96,113,79,37,10,89,54,439
319,Rysheed Jordan,SO,2014-15,G,St. John's (NY),Big East,31,952,143,329,100,211,43,118,109,166,37,77,114,95,54,10,93,82,438
320,Evan Kelley,SR,2014-15,G,Sacred Heart,NEC,32,999,172,375,161,326,11,49,83,136,30,99,129,76,38,7,68,62,438
321,Darion Rackley,SR,2014-15,G,Jacksonville State,OVC,29,941,120,338,80,195,40,143,158,211,29,83,112,62,41,7,77,60,438
322,Jake Layman,JR,2014-15,F,Maryland,Big Ten,35,1053,143,304,98,185,45,119,106,141,45,158,203,49,28,26,67,75,437
323,Mike Talley,SR,2014-15,G,Eastern Michigan,MAC,35,1027,131,302,97,199,34,103,141,199,19,61,80,147,56,0,64,72,437
324,Karrington Ward,SR,2014-15,F,Eastern Michigan,MAC,35,1095,155,371,109,224,46,147,81,115,59,169,228,20,47,46,23,50,437
325,Pascal Siakam,FR,2014-15,F,New Mexico State,WAC,34,1048,166,290,166,288,0,2,104,137,111,151,262,45,28,61,64,88,436
326,Shane Richards,JR,2014-15,F,Manhattan,MAAC,33,1072,128,315,36,73,92,242,87,107,10,109,119,55,27,4,46,72,435
327,Garret Covington,SO,2014-15,G,Western Illinois,Summit,28,925,135,359,72,182,63,177,101,122,7,113,120,65,31,6,76,43,434
328,Malcolm Miller,SR,2014-15,F,Holy Cross,Patriot,30,951,136,306,91,185,45,121,117,141,33,113,146,36,40,48,55,80,434
329,Patricio Garino,JR,2014-15,G-F,George Washington,A-10,35,1107,153,288,137,234,16,54,111,151,75,110,185,52,59,28,89,81,433
330,Seth Hinrichs,SR,2014-15,G,Lafayette,Patriot,33,1027,154,315,102,181,52,134,73,87,54,135,189,84,28,22,69,60,433
331,Roosevelt Jones,JR,2014-15,F,Butler,Big East,34,1207,168,399,168,399,0,0,97,160,70,108,178,125,31,21,89,84,433
332,T.J. Sapp,SR,2014-15,G,Murray State,OVC,35,1070,144,313,78,138,66,175,79,95,15,99,114,102,34,3,68,78,433
333,Aly Ahmed,JR,2014-15,C,Cal State Bakersfield,WAC,31,914,159,323,158,318,1,5,113,154,70,153,223,48,9,23,72,80,432
334,Corey Allen,SR,2014-15,G,South Florida,AAC,28,937,156,351,116,237,40,114,80,101,24,78,102,71,43,9,71,56,432
335,Justin Drummond,SR,2014-15,G-F,Toledo,MAC,33,969,145,303,116,228,29,75,113,145,35,117,152,62,24,16,67,89,432
336,Rashawn Rembert,SR,2014-15,G,East Tennessee State,Southern,30,979,138,336,48,98,90,238,66,80,9,69,78,36,27,3,42,52,432
337,Sterling Smith,JR,2014-15,G,Coppin State,MEAC,31,933,147,314,71,132,76,182,61,79,42,110,152,51,44,15,45,46,431
338,Michael Dison,SR,2014-15,G,Montana State,Big Sky,30,869,150,366,91,215,59,151,71,98,42,79,121,40,31,1,63,62,430
339,Phil Greene,SR,2014-15,G,St. John's (NY),Big East,33,1150,164,385,101,224,63,161,39,54,16,90,106,53,30,1,36,31,430
340,Aaron Harrison,SO,2014-15,G,Kentucky,SEC,39,1004,146,370,87,183,59,187,79,101,15,85,100,55,43,6,35,61,430
341,Myles Mack,SR,2014-15,G,Rutgers,Big Ten,32,1133,141,365,81,180,60,185,88,104,22,105,127,134,56,4,78,48,430
342,Eric Paschall,FR,2014-15,F,Fordham,A-10,27,842,150,358,105,215,45,143,85,107,45,103,148,27,21,12,76,53,430
343,Evan Singletary,JR,2014-15,G,Albany (NY),AEC,33,1153,138,335,77,183,61,152,93,115,14,104,118,94,27,6,67,70,430
344,Javarez Willis,SR,2014-15,G,Ohio,MAC,29,963,152,363,65,141,87,222,39,45,7,84,91,93,25,0,81,47,430
345,Adrian Diaz,JR,2014-15,F,Florida International,CUSA,33,1033,164,272,164,272,0,0,101,176,106,122,228,44,29,99,85,126,429
346,Riley LaChance,FR,2014-15,G,Vanderbilt,SEC,35,1166,147,337,81,164,66,173,69,79,10,100,110,102,25,1,47,46,429
347,Kyle Hittle,JR,2014-15,G,Incarnate Word,Southland,28,1019,141,285,81,140,60,145,86,117,28,150,178,58,27,19,43,65,428
348,Chris Thomas,JR,2014-15,G,Texas Southern,SWAC,34,1055,156,343,135,260,21,83,95,169,65,103,168,56,40,19,86,81,428
349,Rondae Hollis-Jefferson,SO,2014-15,F,Arizona,Pac-12,38,1090,138,275,132,246,6,29,145,205,77,183,260,59,44,32,59,94,427
350,Kentwan Smith,SR,2014-15,F,Stetson,A-Sun,31,880,160,304,134,224,26,80,81,118,85,125,210,40,17,46,74,77,427
351,Juwan Staten,SR,2014-15,G,West Virginia,Big 12,30,938,143,340,122,282,21,58,120,171,14,66,80,139,32,1,61,50,427
352,J.D. Weatherspoon,SR,2014-15,F,Toledo,MAC,33,1038,156,277,146,249,10,28,105,163,67,209,276,34,21,20,67,48,427
353,Jalen Jones,JR,2014-15,G,Texas A&amp;M,SEC,31,892,148,329,136,289,12,40,118,162,59,147,206,25,30,17,45,79,426
354,Anthony McDonald,SR,2014-15,G,North Carolina Central,MEAC,33,1064,134,330,29,53,105,277,53,68,15,47,62,24,21,0,33,62,426
355,Steve McWhorter,SR,2014-15,G,Milwaukee,Horizon,30,1051,147,324,107,206,40,118,92,123,32,110,142,137,49,14,68,91,426
356,Anthony Barber,SO,2014-15,G,North Carolina State,ACC,35,1108,144,328,117,257,27,71,110,150,30,86,116,130,28,0,73,68,425
357,Anthony Holliday,SR,2014-15,G,Lamar,Southland,29,828,135,278,108,203,27,75,128,164,12,43,55,100,31,6,82,65,425
358,Freddie Jackson,SR,2014-15,G,North Carolina-Wilmington,CAA,32,1161,160,367,118,239,42,128,63,99,47,131,178,66,51,13,66,49,425
359,Egidijus Mockevicius,JR,2014-15,C,Evansville,MVC,34,948,154,266,154,266,0,0,117,142,75,262,337,17,21,74,48,99,425
360,Alex Anderson,JR,2014-15,G,Tennessee-Martin,OVC,34,1187,141,292,47,96,94,196,48,54,11,69,80,66,14,0,43,35,424
361,Angelo Warner,SR,2014-15,G,Morehead State,OVC,32,913,146,301,93,168,53,133,79,102,28,100,128,78,51,3,64,72,424
362,Josh Cameron,SR,2014-15,G,Coastal Carolina,Big South,33,719,137,323,73,151,64,172,85,113,14,51,65,50,35,2,48,37,423
363,Louis Dabney,JR,2014-15,G,Tulane,AAC,31,993,135,356,74,192,61,164,92,118,20,81,101,46,35,1,50,64,423
364,Deon Jones,JR,2014-15,G,Monmouth,MAAC,33,931,139,301,123,247,16,54,129,159,49,110,159,41,29,15,54,74,423
365,Shaquielle McKissic,SR,2014-15,F,Arizona State,Pac-12,34,1060,145,332,103,208,42,124,91,135,43,116,159,59,56,6,49,70,423
366,R.J.  Price,SR,2014-15,G,Radford,Big South,34,985,140,382,60,141,80,241,63,92,15,74,89,75,42,4,45,36,423
367,Dez Wells,SR,2014-15,G-F,Maryland,Big Ten,28,853,147,317,122,268,25,49,104,129,36,112,148,77,29,12,92,64,423
368,Jarrod Uthoff,JR,2014-15,F,Iowa,Big Ten,34,1031,156,363,102,218,54,145,56,76,60,158,218,59,38,56,35,52,422
369,Jarekious Bradley,SR,2014-15,G-F,Southeast Missouri State,OVC,26,768,146,343,100,202,46,141,83,94,43,101,144,35,26,18,50,63,421
370,Ethan O'Day,JR,2014-15,F,Vermont,AEC,34,880,175,302,175,302,0,0,71,104,51,106,157,29,28,71,50,103,421
371,Kevin Hardy,SR,2014-15,G,McNeese State,Southland,31,1154,171,356,162,330,9,26,69,125,79,129,208,125,85,32,53,77,420
372,Devin Martin,JR,2014-15,G,Maryland-Eastern Shore,MEAC,30,896,136,322,77,174,59,148,89,111,46,84,130,42,28,7,64,69,420
373,Kennedy Meeks,SO,2014-15,F,North Carolina,ACC,37,862,168,299,168,298,0,1,84,131,95,176,271,39,23,46,58,98,420
374,Mike Scott,SR,2014-15,G,Idaho,Big Sky,30,901,147,333,94,191,53,142,73,95,11,86,97,160,38,6,48,59,420
375,Dion Wright,JR,2014-15,F,St. Bonaventure,A-10,31,1087,175,323,170,309,5,14,65,84,91,126,217,43,26,18,49,84,420
376,Matt Carlino,SR,2014-15,G,Marquette,Big East,28,924,129,320,46,122,83,198,78,95,16,88,104,88,40,2,64,55,419
377,Connar Tava,JR,2014-15,F,Western Michigan,MAC,34,1025,150,288,149,278,1,10,118,174,49,161,210,113,36,11,97,87,419
378,Treshawn Hagood,SR,2014-15,G,Prairie View,SWAC,33,1154,157,386,143,326,14,60,90,151,47,123,170,160,78,3,112,72,418
379,Brett Olson,SR,2014-15,G,Denver,Summit,30,1061,139,288,72,128,67,160,73,87,12,89,101,90,24,4,52,83,418
380,Troy Williams,SO,2014-15,F,Indiana,Big Ten,32,882,161,298,155,285,6,13,89,120,71,167,238,64,32,15,71,72,417
381,Wayne Blackshear,SR,2014-15,G-F,Louisville,ACC,36,1129,132,334,72,153,60,181,92,118,34,120,154,42,37,21,37,93,416
382,Przemek Karnowski,JR,2014-15,C,Gonzaga,WCC,38,932,179,288,178,287,1,1,57,112,70,150,220,51,20,39,68,85,416
383,Kevon Looney,FR,2014-15,F,UCLA,Pac-12,36,1113,151,321,129,268,22,53,92,147,122,209,331,51,46,32,45,104,416
384,Fred Miller,SR,2014-15,G,South Carolina Upstate,A-Sun,34,1084,150,364,104,221,46,143,70,90,17,153,170,143,62,7,97,77,416
385,Gary Payton,JR,2014-15,G,Oregon State,Pac-12,31,1125,162,334,135,242,27,92,65,98,64,167,231,98,95,37,59,84,416
386,Branden Dawson,SR,2014-15,G-F,Michigan State,Big Ten,35,1055,182,340,182,340,0,0,51,104,102,216,318,59,42,58,67,72,415
387,Kayel Locke,JR,2014-15,F,North Carolina-Greensboro,Southern,33,973,158,342,155,325,3,17,96,147,74,115,189,26,11,9,61,92,415
388,Marquis Vance,SO,2014-15,F,Alcorn State,SWAC,32,1075,132,350,109,268,23,82,128,190,67,183,250,54,21,21,61,70,415
389,Trevor Cooney,JR,2014-15,G,Syracuse,ACC,31,1156,135,376,64,146,71,230,73,95,17,71,88,68,56,1,46,48,414
390,Ethan Jacobs,SR,2014-15,C,Colgate,Patriot,33,921,159,322,119,205,40,117,56,74,32,117,149,35,11,37,52,88,414
391,Taishaun Johnson,FR,2014-15,G,South Alabama,Sun Belt,33,1035,118,316,78,179,40,137,138,177,36,100,136,71,32,7,102,90,414
392,Zach Lewis,SO,2014-15,G,Canisius,MAAC,33,1062,135,404,60,166,75,238,69,94,17,82,99,83,52,7,62,71,414
393,Tevon Saddler,SO,2014-15,G,North Carolina-Greensboro,Southern,31,947,152,354,140,300,12,54,98,148,38,104,142,123,46,17,111,111,414
394,Tanner Samson,JR,2014-15,G,Elon,CAA,33,979,121,346,18,60,103,286,69,82,10,129,139,44,43,8,44,84,414
395,Canyon Barry,SO,2014-15,G,College of Charleston,CAA,33,1147,146,385,82,211,64,174,57,79,28,139,167,53,38,16,66,62,413
396,Dillon Brooks,FR,2014-15,F,Oregon,Pac-12,36,1020,150,329,122,246,28,83,85,103,62,114,176,65,18,20,73,111,413
397,T.J. Cline,SO,2014-15,F,Richmond,A-10,35,812,162,314,112,185,50,129,39,60,26,104,130,55,25,7,52,78,413
398,Mandell Thomas,JR,2014-15,G,Fordham,A-10,31,1065,140,346,104,244,36,102,97,130,38,86,124,112,73,13,67,83,413
399,B.J. Tyson,FR,2014-15,G,East Carolina,AAC,33,798,143,312,124,249,19,63,108,150,45,84,129,46,26,3,51,55,413
400,Cinmeon Bowers,JR,2014-15,F,Auburn,SEC,34,1023,154,370,149,342,5,28,99,207,123,203,326,45,36,20,85,89,412
401,Spencer Collins,JR,2014-15,G,Wofford,Southern,35,965,140,303,97,191,43,112,89,112,21,75,96,50,23,2,47,60,412
402,Brett Comer,SR,2014-15,G,Florida Gulf Coast,A-Sun,33,1052,143,343,104,223,39,120,87,127,20,95,115,236,42,5,80,71,412
403,Wesley Person,FR,2014-15,G,Troy,Sun Belt,29,1010,133,325,59,126,74,199,72,91,22,59,81,29,13,2,49,55,412
404,Paris Bass,FR,2014-15,G-F,Detroit Mercy,Horizon,33,831,152,333,129,269,23,64,83,130,55,132,187,62,39,35,84,89,410
405,Kethan Savage,JR,2014-15,G,George Washington,A-10,35,1055,126,314,102,234,24,80,134,182,35,133,168,80,34,15,77,83,410
406,Rashad Vaughn,FR,2014-15,G,Nevada-Las Vegas,MWC,23,742,144,328,90,187,54,141,68,98,14,97,111,36,18,8,50,54,410
407,Isaiah Cousins,JR,2014-15,G,Oklahoma,Big 12,35,1079,150,354,87,214,63,140,46,71,33,128,161,77,43,13,72,65,409
408,Erik McCree,SO,2014-15,F,Louisiana Tech,CUSA,36,878,150,316,116,212,34,104,75,106,51,151,202,21,26,16,55,69,409
409,Trevon Bluiett,FR,2014-15,F,Xavier,Big East,37,1048,133,315,88,177,45,138,97,130,52,104,156,71,23,2,51,83,408
410,Joe Chealey,SO,2014-15,G,College of Charleston,CAA,33,1073,131,326,98,218,33,108,113,149,19,100,119,109,29,6,79,101,408
411,Derrick Colter,JR,2014-15,G,Duquesne,A-10,31,988,134,302,74,161,60,141,80,103,22,67,89,113,29,2,56,65,408
412,Justin Jackson,FR,2014-15,F-G,North Carolina,ACC,38,1014,157,329,129,237,28,92,66,93,52,87,139,88,20,19,52,55,408
413,Jaron Blossomgame,SO,2014-15,F,Clemson,ACC,31,958,144,296,127,237,17,59,102,144,76,177,253,30,24,11,54,45,407
414,Majok Deng,JR,2014-15,F,Louisiana-Monroe,Sun Belt,38,1166,144,326,103,207,41,119,78,102,84,195,279,43,22,51,54,85,407
415,Marcus Georges-Hunt,JR,2014-15,F,Georgia Tech,ACC,30,926,135,313,114,240,21,73,116,152,56,109,165,54,39,4,59,64,407
416,Terry Whisnant,JR,2014-15,G,East Carolina,AAC,33,1041,131,327,54,119,77,208,68,89,25,62,87,60,31,3,40,61,407
417,Emile Blackman,SO,2014-15,G,Niagara,MAAC,30,956,153,333,112,226,41,107,59,71,45,73,118,43,25,10,58,74,406
418,Monte Morris,SO,2014-15,G,Iowa State,Big 12,34,1153,155,306,123,225,32,81,64,85,24,93,117,176,64,15,38,45,406
419,Brian Sullivan,JR,2014-15,G,Davidson,A-10,32,1066,134,342,51,108,83,234,55,72,6,89,95,124,22,1,45,66,406
420,Alec Wintering,SO,2014-15,G,Portland,WCC,33,1064,115,265,82,193,33,72,143,180,19,73,92,187,50,1,84,84,406
421,Jack Gibbs,SO,2014-15,G,Davidson,A-10,25,750,125,261,71,134,54,127,101,118,20,73,93,120,38,0,62,49,405
422,A.J. Hammons,JR,2014-15,C,Purdue,Big Ten,34,827,157,291,157,284,0,7,91,136,82,144,226,31,17,96,73,87,405
423,TaShawn Thomas,SR,2014-15,F,Oklahoma,Big 12,35,1038,160,308,160,305,0,3,85,123,77,151,228,51,22,53,68,73,405
424,Jamel Waters,JR,2014-15,G,Alabama State,SWAC,29,939,147,340,112,229,35,111,76,101,23,86,109,152,58,5,71,69,405
425,Korey Billbury,JR,2014-15,G,Oral Roberts,Summit,28,929,141,356,113,277,28,79,94,140,57,149,206,80,40,6,69,71,404
426,Tevin Svihovec,SR,2014-15,G,Northern Colorado,Big Sky,30,921,143,331,122,271,21,60,97,128,13,93,106,84,26,1,59,41,404
427,Caleb White,SO,2014-15,G,East Carolina,AAC,33,1021,138,313,71,149,67,164,61,77,24,92,116,46,15,5,50,65,404
428,Tim Derksen,JR,2014-15,G,San Francisco,WCC,32,935,133,281,91,176,42,105,95,142,36,108,144,74,32,3,45,66,403
429,Christian Thomas,SR,2014-15,G-F,Loyola (IL),MVC,36,998,160,284,145,250,15,34,68,107,58,104,162,34,17,9,56,87,403
430,Winfield Willis,JR,2014-15,G,NJIT,Ind,33,982,130,274,71,139,59,135,84,99,33,71,104,79,36,5,56,93,403
431,Tyran de Lattibeaudiere,SR,2014-15,F,Lamar,Southland,30,893,167,290,167,290,0,0,68,128,86,146,232,47,40,63,94,99,402
432,Byron Wesley,SR,2014-15,G,Gonzaga,WCC,38,1014,143,278,133,246,10,32,106,158,48,131,179,87,37,12,60,59,402
433,Tre Demps,JR,2014-15,G,Northwestern,Big Ten,32,1043,149,354,94,200,55,154,48,73,13,84,97,84,9,1,47,49,401
434,Harrison Hawkins,SR,2014-15,G,Abilene Christian,Southland,31,741,142,324,85,168,57,156,60,76,10,26,36,46,25,3,72,80,401
435,Cody Joyce,JR,2014-15,F,Maryland-Baltimore County,AEC,30,1012,148,293,148,293,0,0,105,157,46,127,173,32,17,18,68,83,401
436,Karl-Anthony Towns,FR,2014-15,F,Kentucky,SEC,39,822,145,256,143,248,2,8,109,134,92,169,261,44,18,88,53,115,401
437,Tyshawn Bell,SR,2014-15,F,Delaware State,MEAC,36,1067,139,343,66,148,73,195,49,58,45,154,199,35,33,8,31,87,400
438,Joel Bolomboy,JR,2014-15,F-C,Weber State,Big Sky,30,997,131,277,116,236,15,41,122,166,107,199,306,25,20,51,80,71,399
439,Kris Davis,SR,2014-15,G,Southern Illinois-Edwardsville,OVC,28,881,135,285,85,171,50,114,79,113,6,100,106,40,29,2,65,35,399
440,Winston Shepard,JR,2014-15,F,San Diego State,MWC,36,955,138,339,121,282,17,57,106,158,64,126,190,67,22,10,88,54,399
441,Darius Carter,SR,2014-15,F,Wichita State,MVC,35,750,157,300,153,293,4,7,80,124,66,123,189,19,15,21,37,79,398
442,Matt Tiby,JR,2014-15,F,Milwaukee,Horizon,30,884,121,290,90,195,31,95,125,154,39,195,234,57,12,12,79,80,398
443,Jerrell Wright,JR,2014-15,F,La Salle,A-10,33,922,155,296,155,296,0,0,88,146,96,119,215,49,24,24,74,91,398
444,David Collette,FR,2014-15,F,Utah State,MWC,31,792,163,276,161,270,2,6,69,116,47,109,156,37,25,56,36,115,397
445,Cameron Golden,JR,2014-15,G,Arkansas State,Sun Belt,29,1016,133,366,72,169,61,197,70,99,15,76,91,78,49,5,63,56,397
446,Kendall Gray,SR,2014-15,C,Delaware State,MEAC,34,1149,150,272,150,271,0,1,97,153,111,290,401,35,15,95,70,92,397
447,Greg Mays,SR,2014-15,F,Green Bay,Horizon,33,926,154,310,141,257,13,53,76,113,43,112,155,28,14,48,62,65,397
448,John Schoof,SR,2014-15,G,American,Patriot,33,1239,145,310,77,141,68,169,39,56,21,83,104,53,28,9,54,78,397
449,Trae Anderson,JR,2014-15,G-F,Eastern Illinois,OVC,30,749,148,307,132,265,16,42,84,129,55,93,148,55,24,18,70,86,396
450,Brian Bernardi,SO,2014-15,G,Hofstra,CAA,34,1162,127,303,32,68,95,235,47,55,5,99,104,58,32,7,39,58,396
451,Micah Mason,JR,2014-15,G,Duquesne,A-10,31,1011,135,287,47,90,88,197,38,42,13,110,123,89,35,1,41,45,396
452,Rayvonte Rice,JR,2014-15,G,Illinois,Big Ten,24,721,130,276,86,175,44,101,92,114,32,123,155,44,43,7,31,64,396
453,Edward Stephens,FR,2014-15,G,South Carolina State,MEAC,33,887,134,329,71,154,63,175,65,87,24,69,93,58,38,0,51,53,396
454,Jarvis Summers,SR,2014-15,G,Mississippi,SEC,33,965,122,369,93,251,29,118,123,164,14,47,61,160,28,4,67,68,396
455,Steve Forbes,SR,2014-15,F,IPFW,Summit,28,678,141,249,141,249,0,0,113,150,59,111,170,29,9,22,51,71,395
456,Anthony Gill,JR,2014-15,F,Virginia,ACC,34,859,142,244,142,243,0,1,111,164,102,118,220,29,29,16,39,74,395
457,Mustafaa Jones,SR,2014-15,G,Fairleigh Dickinson,NEC,29,933,125,325,49,120,76,205,69,79,7,50,57,55,42,2,63,59,395
458,T.J. McConnell,SR,2014-15,G,Arizona,Pac-12,38,1158,156,313,131,235,25,78,58,70,25,121,146,238,83,3,78,68,395
459,Rico Gathers,JR,2014-15,F,Baylor,Big 12,34,1015,134,292,134,292,0,0,126,204,164,230,394,16,41,35,35,91,394
460,Nikola Jovanovic,SO,2014-15,F,Southern California,Pac-12,32,896,154,299,152,286,2,13,84,130,74,150,224,15,13,24,71,88,394
461,Jeremy Senglin,SO,2014-15,G,Weber State,Big Sky,24,845,115,276,70,146,45,130,119,152,13,65,78,84,27,1,63,53,394
462,Billy Garrett,SO,2014-15,G,DePaul,Big East,32,961,100,252,65,145,35,107,158,190,4,74,78,126,22,8,74,90,393
463,Stanton Kidd,SR,2014-15,F,Colorado State,MWC,34,1023,148,319,111,227,37,92,60,81,76,96,172,62,28,28,50,82,393
464,Devin Williams,SO,2014-15,F,West Virginia,Big 12,34,847,127,285,127,284,0,1,139,198,94,182,276,45,26,9,75,100,393
465,Marcus Colbert,JR,2014-15,G,Montana State,Big Sky,30,905,128,301,78,183,50,118,86,113,23,71,94,140,26,1,93,79,392
466,Chris Horton,JR,2014-15,C-F,Austin Peay,OVC,30,1034,142,310,142,309,0,1,108,156,135,198,333,43,35,70,75,62,392
467,Tony Parker,JR,2014-15,F-C,UCLA,Pac-12,34,838,150,276,150,276,0,0,92,160,93,136,229,14,19,31,59,118,392
468,Tayler Persons,FR,2014-15,G,Northern Kentucky,A-Sun,30,860,146,335,136,281,10,54,90,118,30,107,137,112,33,4,78,76,392
469,John Simons,JR,2014-15,F,Central Michigan,MAC,32,982,121,243,30,43,91,200,59,70,51,156,207,22,36,16,22,68,392
470,Arlon Harper,SR,2014-15,G,Charleston Southern,Big South,30,928,139,349,89,203,50,146,63,93,20,103,123,65,53,12,46,65,391
471,Jeffrey Moss,JR,2014-15,F,Murray State,OVC,35,1160,136,279,81,149,55,130,64,75,33,101,134,76,37,4,42,78,391
472,Rob Poole,SR,2014-15,G,Siena,MAAC,28,930,119,301,64,148,55,153,98,117,34,96,130,50,31,5,45,66,391
473,Chris Smith,JR,2014-15,G,Utah State,MWC,31,996,128,267,65,134,63,133,72,94,12,107,119,79,21,6,46,66,391
474,Maurice Walker,SR,2014-15,F,Minnesota,Big Ten,33,799,152,264,152,264,0,0,87,120,73,147,220,22,48,44,67,88,391
475,Ryan Bowie,JR,2014-15,G,Texas-San Antonio,CUSA,30,1013,140,317,78,147,62,170,48,69,59,115,174,57,35,10,43,68,390
476,Charles Jackson,JR,2014-15,C,Tennessee Tech,OVC,30,816,157,275,157,275,0,0,76,133,111,175,286,14,33,40,47,100,390
477,Clarke Rosenberg,SR,2014-15,G,Chicago State,WAC,31,876,137,345,99,222,38,123,78,116,38,83,121,63,36,12,74,81,390
478,Kadeem Jack,SR,2014-15,F,Rutgers,Big Ten,30,930,154,361,139,313,15,48,66,114,74,118,192,33,28,21,79,68,389
479,Derius Jones-Gibson,JR,2014-15,G,Samford,Southern,32,856,128,264,123,242,5,22,128,204,29,69,98,69,42,3,58,77,389
480,Nigel Pruitt,JR,2014-15,F,Kennesaw State,A-Sun,32,902,128,309,58,120,70,189,63,82,35,94,129,40,31,9,53,82,389
481,Will Saunders,SR,2014-15,F,Charleston Southern,Big South,30,828,123,297,28,64,95,233,48,67,45,136,181,30,20,5,38,89,389
482,Montay Brandon,JR,2014-15,G,Florida State,ACC,33,1142,133,246,128,225,5,21,117,174,49,134,183,63,36,13,76,59,388
483,Katin Reinhardt,SO,2014-15,G,Southern California,Pac-12,31,887,137,361,76,203,61,158,53,65,16,59,75,54,30,5,61,37,388
484,Shevon Thompson,JR,2014-15,C,George Mason,A-10,31,936,151,272,151,272,0,0,86,139,144,207,351,6,17,34,76,69,388
485,RJ White,SO,2014-15,C,North Carolina-Greensboro,Southern,33,784,155,278,137,234,18,44,60,104,64,165,229,38,43,50,48,125,388
486,Faronte Drakeford,SR,2014-15,F,Central Connecticut State,NEC,30,937,142,341,140,327,2,14,101,130,72,139,211,48,38,5,89,89,387
487,Nick Lindner,SO,2014-15,G,Lafayette,Patriot,31,994,125,255,96,182,29,73,108,127,13,52,65,162,20,2,62,59,387
488,Duane Notice,SO,2014-15,G,South Carolina,SEC,33,987,127,337,66,169,61,168,72,91,20,67,87,89,29,4,60,61,387
489,Zay Jackson,JR,2014-15,G,Southeastern Louisiana,Southland,25,915,146,344,107,208,39,136,55,76,10,103,113,115,33,8,100,64,386
490,Marquis Wright,SO,2014-15,G,Siena,MAAC,31,1134,138,322,125,277,13,45,97,142,50,81,131,157,63,11,78,80,386
491,Matt Bingaya,FR,2014-15,G-F,Southern Mississippi,CUSA,28,914,135,309,110,217,25,92,90,132,38,126,164,60,37,15,78,61,385
492,Quinton Hooker,SO,2014-15,G,North Dakota,Big Sky,30,1025,133,296,108,222,25,74,94,124,24,104,128,127,44,8,67,67,385
493,Lanerryl Johnson,JR,2014-15,G,Cal State Fullerton,Big West,31,680,126,311,68,176,58,135,75,89,10,38,48,47,23,0,47,57,385
494,Four McGlynn,JR,2014-15,G,Towson,CAA,32,900,104,264,49,117,55,147,122,133,11,60,71,51,11,6,60,57,385
495,Andris Misters,JR,2014-15,G,Jacksonville,A-Sun,32,906,122,290,72,159,50,131,91,112,21,97,118,52,34,3,57,52,385
496,Devin Thomas,JR,2014-15,F,Wake Forest,ACC,32,869,138,279,138,279,0,0,109,184,82,200,282,51,22,26,96,88,385
497,Elijah Wilson,SO,2014-15,G,Coastal Carolina,Big South,34,915,129,328,63,159,66,169,61,86,31,87,118,22,22,6,40,52,385
498,Torin Dorn,FR,2014-15,G,Charlotte,CUSA,32,880,147,291,120,212,27,79,63,96,25,92,117,40,20,4,59,37,384
499,Myke Henry,JR,2014-15,F,DePaul,Big East,32,898,148,319,117,236,31,83,57,83,66,108,174,38,35,18,70,113,384
500,Danuel House,JR,2014-15,G,Texas A&amp;M,SEC,26,845,125,300,63,145,62,155,72,112,22,76,98,55,17,16,50,42,384
501,Rodney Purvis,SO,2014-15,G,Connecticut,AAC,33,947,144,336,90,186,54,150,42,78,10,68,78,40,27,5,62,60,384
502,Blake Bozeman,SR,2014-15,G,Morgan State,MEAC,31,1065,125,356,56,143,69,213,64,91,13,62,75,52,18,0,54,59,383
503,Chris Davenport,SO,2014-15,F,North Florida,A-Sun,34,954,134,249,120,211,14,38,101,136,46,175,221,76,29,35,76,91,383
504,Myles Davis,SO,2014-15,G,Xavier,Big East,36,967,109,277,46,113,63,164,102,117,11,77,88,77,32,0,49,67,383
505,Steve Vasturia,SO,2014-15,G,Notre Dame,ACC,38,1235,133,271,73,125,60,146,57,66,18,96,114,65,42,5,45,84,383
506,Emani Gant,JR,2014-15,F,Texas State,Sun Belt,30,917,145,305,144,304,1,1,91,142,75,132,207,49,37,17,77,89,382
507,Angel Rodriguez,JR,2014-15,G,Miami (FL),ACC,32,906,110,326,62,168,48,158,114,153,14,61,75,126,59,9,74,89,382
508,Marcus  Thornton,SR,2014-15,F,Georgia,SEC,31,905,135,281,126,251,9,30,103,149,53,173,226,32,23,35,46,94,382
509,Devin Booker,FR,2014-15,G,Kentucky,SEC,38,816,135,287,77,146,58,141,53,64,17,59,76,42,17,2,37,58,381
510,Marquan Botley,SO,2014-15,G,Florida Atlantic,CUSA,29,949,127,348,76,193,51,155,76,96,13,51,64,112,13,1,59,46,381
511,Austin Chatman,SR,2014-15,G,Creighton,Big East,33,1115,117,316,72,171,45,145,102,126,21,93,114,121,16,2,67,59,381
512,Tim Coleman,SO,2014-15,F,NJIT,Ind,33,831,131,249,96,165,35,84,84,130,38,131,169,57,37,42,71,95,381
513,Michael Gbinije,JR,2014-15,F,Syracuse,ACC,30,1050,138,300,89,175,49,125,56,98,35,115,150,107,56,10,64,84,381
514,Isaac Hamilton,SO,2014-15,G,UCLA,Pac-12,36,1222,139,340,80,188,59,152,44,64,38,84,122,116,32,6,83,83,381
515,Johnathan Williams,SO,2014-15,F,Missouri,SEC,32,941,128,311,106,247,22,64,103,167,78,150,228,27,10,19,82,86,381
516,Jamee Crockett,SR,2014-15,F,DePaul,Big East,32,993,137,292,95,169,42,123,64,91,36,62,98,43,45,18,49,82,380
517,Dionte Ferguson,JR,2014-15,G,South Alabama,Sun Belt,33,927,130,240,130,239,0,1,120,162,98,124,222,19,24,51,74,106,380
518,Daniel Hamilton,FR,2014-15,G-F,Connecticut,AAC,35,1100,139,366,93,232,46,134,56,84,37,230,267,128,33,13,81,86,380
519,Kevin Larsen,JR,2014-15,F,George Washington,A-10,35,1162,144,294,137,275,7,19,85,139,111,148,259,83,17,36,66,55,380
520,Jalen Nesbitt,SR,2014-15,G,North Florida,A-Sun,35,1136,107,226,78,148,29,78,137,188,55,144,199,118,58,25,84,71,380
521,Duane Wilson,FR,2014-15,G,Marquette,Big East,32,899,121,307,72,169,49,138,89,125,13,64,77,68,38,8,59,79,380
522,Gerry Blakes,JR,2014-15,G,Arizona State,Pac-12,34,866,140,346,101,217,39,129,60,73,20,124,144,60,28,3,80,67,379
523,Joshua Braun,FR,2014-15,G,Grand Canyon,WAC,32,857,134,291,78,144,56,147,55,71,38,119,157,24,27,26,22,59,379
524,Tim Quarterman,SO,2014-15,G,Louisiana State,SEC,33,1105,125,293,85,165,40,128,89,124,50,123,173,133,47,19,80,84,379
525,Terry Tarpey,JR,2014-15,G-F,William &amp; Mary,CAA,32,1000,133,251,109,181,24,70,89,108,42,226,268,102,58,40,52,74,379
526,Brent Arrington,JR,2014-15,G,Morehead State,OVC,34,957,121,299,89,200,32,99,104,136,44,87,131,77,65,30,65,107,378
527,John Davis,SO,2014-15,F,Towson,CAA,32,820,144,308,143,306,1,2,89,136,96,163,259,9,7,16,54,79,378
528,Willie Rodriguez,FR,2014-15,F,Binghamton,AEC,32,1011,137,313,123,249,14,64,90,131,44,131,175,41,26,23,87,80,378
529,Jeffrey Solarin,SR,2014-15,F,Idaho State,Big Sky,30,957,167,300,167,300,0,0,44,84,110,158,268,28,19,27,57,63,378
530,LaDarius White,SR,2014-15,G,Mississippi,SEC,34,807,126,304,68,158,58,146,68,91,13,95,108,45,26,6,52,51,378
531,Daniel Bejarano,SR,2014-15,G,Colorado State,MWC,33,1014,127,359,62,178,65,181,58,84,50,186,236,94,13,20,52,78,377
532,Shaquille Boga,SR,2014-15,G,Texas-Pan American,WAC,30,1035,139,367,96,222,43,145,56,75,12,79,91,108,40,3,68,62,377
533,Shaquille Hines,JR,2014-15,F,Texas-Pan American,WAC,31,1040,163,320,163,309,0,11,51,84,65,101,166,44,22,14,63,82,377
534,Dwight Meikle,JR,2014-15,G,Hampton,MEAC,29,807,153,295,145,268,8,27,63,93,62,156,218,19,23,43,79,89,377
535,Yanick Moreira,SR,2014-15,C,Southern Methodist,AAC,34,828,144,262,144,262,0,0,89,139,80,139,219,33,24,40,60,61,377
536,T.J. Wallace,SO,2014-15,G,Pacific,WCC,29,894,125,313,89,206,36,107,91,123,43,120,163,75,21,2,80,100,377
537,Lester Wilson,JR,2014-15,F,East Tennessee State,Southern,30,846,132,308,60,103,72,205,41,56,31,82,113,14,24,9,38,72,377
538,Yohanny Dalembert,SO,2014-15,F,James Madison,CAA,33,831,137,237,136,236,1,1,101,150,71,126,197,35,15,37,70,94,376
539,Hassan Martin,SO,2014-15,F,Rhode Island,A-10,33,949,146,244,146,239,0,5,84,138,74,180,254,11,24,103,44,86,376
540,Dion Nesmith,SR,2014-15,G,Hofstra,CAA,34,961,132,294,83,146,49,148,63,76,29,79,108,87,46,1,45,89,376
541,Josh Scott,JR,2014-15,F,Colorado,Pac-12,26,802,130,239,129,235,1,4,115,153,89,130,219,29,18,46,24,45,376
542,Kerry Carter,SR,2014-15,G,Saint Mary's (CA),WCC,31,1041,120,294,46,107,74,187,61,92,29,125,154,46,47,6,56,93,375
543,Josh Hagins,JR,2014-15,G,Arkansas-Little Rock,Sun Belt,31,785,131,313,88,186,43,127,70,84,32,91,123,93,52,5,50,77,375
544,Rashad Muhammad,SO,2014-15,G,San Jose State,MWC,27,871,119,312,60,148,59,164,78,98,17,71,88,31,18,3,38,48,375
545,John Green,JR,2014-15,G,California-Santa Barbara,Big West,33,814,153,321,125,245,28,76,40,60,46,89,135,49,14,6,57,108,374
546,Antoine Mason,SR,2014-15,G,Auburn,SEC,26,752,110,264,65,152,45,112,109,150,9,53,62,25,26,1,46,58,374
547,Cameron Michael,SO,2014-15,G,Northern Colorado,Big Sky,29,823,128,295,62,127,66,168,52,69,10,73,83,37,20,2,37,67,374
548,Alex Olah,JR,2014-15,C,Northwestern,Big Ten,32,941,135,278,126,240,9,38,95,127,62,158,220,49,19,59,55,83,374
549,Jeffrey Simmons,SR,2014-15,G,Mississippi Valley State,SWAC,32,888,159,364,149,318,10,46,46,73,16,61,77,73,35,0,90,54,374
550,Nimrod Hilliard,SR,2014-15,G,North Carolina Central,MEAC,31,1097,127,263,94,184,33,79,86,99,15,76,91,196,35,15,89,60,373
551,David Kravish,SR,2014-15,F,California,Pac-12,33,973,162,339,158,325,4,14,45,62,58,172,230,38,13,49,50,104,373
552,Taariq Cephas,SR,2014-15,G,Coppin State,MEAC,31,980,132,322,76,176,56,146,52,77,27,81,108,151,46,1,69,67,372
553,DeMarcus Gatlin,SR,2014-15,G,Sam Houston State,Southland,35,818,123,259,107,203,16,56,110,160,61,111,172,69,34,22,46,86,372
554,Brandon Taylor,JR,2014-15,G,Utah,Pac-12,35,1056,121,272,39,85,82,187,48,56,7,83,90,117,45,0,58,54,372
555,Quinton Chievous,SR,2014-15,G,Hampton,MEAC,35,891,126,288,102,191,24,97,95,154,55,174,229,32,16,3,70,70,371
556,Joseph Edwards,SR,2014-15,G,IPFW,Summit,31,987,138,276,98,182,40,94,55,87,30,62,92,69,32,8,56,51,371
557,Ricky Johnson,JR,2014-15,G,Bethune-Cookman,MEAC,28,892,104,303,67,173,37,130,126,151,15,57,72,67,38,2,63,67,371
558,Karam Mashour,SR,2014-15,F,Morehead State,OVC,34,748,139,282,119,211,20,71,73,104,53,149,202,32,33,13,45,75,371
559,Shawn Amiker,SR,2014-15,G,Youngstown State,Horizon,32,919,140,301,132,276,8,25,82,121,60,123,183,30,20,13,54,97,370
560,Devonte Brown,JR,2014-15,G,Indiana State,MVC,31,1020,113,246,87,174,26,72,118,183,13,124,137,101,28,4,103,70,370
561,Cady Lalanne,SR,2014-15,C,Massachusetts,A-10,32,929,138,250,135,232,3,18,91,143,110,194,304,10,19,61,80,87,370
562,Teddy Okereafor,JR,2014-15,G,Rider,MAAC,33,1121,114,298,65,144,49,154,93,128,26,127,153,133,59,4,84,40,370
563,Craig Ponder,JR,2014-15,G,North Carolina-Wilmington,CAA,32,1032,122,292,76,190,46,102,80,117,13,95,108,85,34,5,71,95,370
564,A'Torri Shine,SR,2014-15,G-F,Grambling,SWAC,29,916,131,337,82,190,49,147,59,80,27,76,103,24,26,5,58,58,370
565,Jontrell Walker,FR,2014-15,G,Incarnate Word,Southland,27,807,119,278,71,147,48,131,84,98,13,46,59,49,25,1,63,45,370
566,Charles Mann,JR,2014-15,G,Georgia,SEC,33,1009,104,260,90,209,14,51,147,220,23,140,163,119,21,4,106,99,369
567,J.J. O'Brien,SR,2014-15,F,San Diego State,MWC,36,1183,149,320,138,285,11,35,60,93,79,108,187,88,51,7,54,47,369
568,Domantas Sabonis,FR,2014-15,F,Gonzaga,WCC,38,822,145,217,145,217,0,0,79,119,82,186,268,33,17,12,59,104,369
569,Anson Winder,SR,2014-15,G,Brigham Young,WCC,29,739,124,260,79,143,45,117,76,105,16,84,100,52,39,6,31,57,369
570,Eric Fanning,SO,2014-15,G,Boston University,Patriot,30,640,106,218,82,157,24,61,132,174,21,87,108,44,13,4,55,72,368
571,Leron Fisher,JR,2014-15,G,Longwood,Big South,34,927,114,269,68,155,46,114,94,123,19,74,93,85,65,4,68,78,368
572,Tre Lynch,SR,2014-15,G,Southern,SWAC,30,661,125,312,74,160,51,152,67,80,28,80,108,31,25,5,36,41,368
573,Roger Woods,JR,2014-15,F,Arkansas-Little Rock,Sun Belt,31,818,131,275,118,246,13,29,93,145,71,132,203,33,22,17,55,75,368
574,Jordan Barham,JR,2014-15,G,Davidson,A-10,31,671,148,251,140,234,8,17,63,101,66,122,188,34,12,12,33,76,367
575,Rodney Cooper,SR,2014-15,G,Alabama,SEC,33,1040,127,268,78,137,49,131,64,80,35,86,121,52,21,8,55,90,367
576,Dorian Finney-Smith,JR,2014-15,F,Florida,SEC,28,782,137,290,88,175,49,115,44,75,73,101,174,44,32,24,54,74,367
577,Rhett Harrelson,JR,2014-15,G,Western Carolina,Southern,31,1056,114,297,29,73,85,224,54,73,17,46,63,73,45,2,75,64,367
578,Carlos Morris,JR,2014-15,G,Minnesota,Big Ten,33,846,133,294,101,206,32,88,69,95,22,83,105,70,58,7,69,61,367
579,Jalen Reynolds,SO,2014-15,F,Xavier,Big East,37,751,152,246,152,245,0,1,63,95,69,155,224,13,21,36,44,115,367
580,Sindarius Thornwell,SO,2014-15,G,South Carolina,SEC,33,1011,114,335,76,193,38,142,101,141,50,111,161,73,43,11,71,83,367
581,Kevin Bailey,SR,2014-15,G,Portland,WCC,25,674,123,296,93,210,30,86,90,111,8,55,63,47,13,12,54,66,366
582,Bryant McIntosh,FR,2014-15,G,Northwestern,Big Ten,32,1066,134,318,94,208,40,110,58,68,10,69,79,150,8,6,79,34,366
583,Josh Ritchart,SR,2014-15,G-F,California-Davis,Big West,31,745,135,273,71,133,64,140,32,43,32,96,128,24,12,13,36,72,366
584,Rapheal Davis,JR,2014-15,G,Purdue,Big Ten,34,1065,122,268,104,208,18,60,103,141,39,109,148,88,28,8,65,78,365
585,Josh Hart,SO,2014-15,G,Villanova,Big East,36,917,124,241,72,129,52,112,65,97,65,96,161,53,40,14,38,76,365
586,Darious Moten,JR,2014-15,F,Mercer,Southern,32,894,128,263,109,225,19,38,90,122,61,80,141,41,24,29,44,61,365
587,Kendrick Nunn,SO,2014-15,G,Illinois,Big Ten,33,996,131,327,77,177,54,150,49,60,13,103,116,62,39,6,45,54,365
588,Ryan Arcidiacono,JR,2014-15,G,Villanova,Big East,36,1095,109,277,54,129,55,148,91,112,10,52,62,129,40,2,48,64,364
589,Quincy Ford,JR,2014-15,F-G,Northeastern,CAA,35,1101,113,282,58,135,55,147,83,110,41,147,188,79,34,37,73,63,364
590,Andrew Harrison,SO,2014-15,G,Kentucky,SEC,39,994,101,267,65,173,36,94,126,159,13,74,87,139,40,8,64,70,364
591,Devonta Pollard,JR,2014-15,F,Houston,AAC,32,976,132,289,132,288,0,1,100,138,84,121,205,39,39,14,75,87,364
592,Darien Walker,JR,2014-15,G,Valparaiso,Horizon,34,924,129,333,76,186,53,147,53,83,31,124,155,60,26,10,56,52,364
593,Nemanja Djurisic,SR,2014-15,F,Georgia,SEC,33,991,130,278,96,178,34,100,69,98,62,111,173,48,23,16,61,74,363
594,Maxie Esho,SR,2014-15,F,Massachusetts,A-10,32,863,133,266,129,254,4,12,93,137,62,142,204,30,23,28,66,96,363
595,Kenny Gaines,JR,2014-15,G,Georgia,SEC,31,930,125,303,69,151,56,152,57,80,23,83,106,50,35,28,47,79,363
596,Austin Loop,SO,2014-15,G,Marshall,CUSA,32,1033,108,257,24,43,84,214,63,71,24,51,75,26,33,4,32,57,363
597,Earvin Morris,JR,2014-15,F,Texas-El Paso,CUSA,33,767,120,268,65,131,55,137,68,97,7,69,76,38,28,10,56,77,363
598,AJ West,JR,2014-15,C,Nevada,MWC,30,873,125,254,125,254,0,0,113,174,178,153,331,17,15,79,72,84,363
599,Kris Brewer,SR,2014-15,G,Kent State,MAC,34,994,111,301,68,167,43,134,97,145,13,59,72,96,19,4,66,58,362
600,Marcus Foster,SO,2014-15,G,Kansas State,Big 12,29,807,116,299,57,129,59,170,71,101,8,58,66,55,17,2,62,55,362
601,Derek Jackson,SR,2014-15,G,Kent State,MAC,34,1181,122,291,56,135,66,156,52,71,22,88,110,114,58,7,50,56,362
602,Julien Lewis,JR,2014-15,G,Fresno State,MWC,32,944,140,353,119,254,21,99,61,77,22,99,121,35,47,8,54,100,362
603,Andrew Ryan,SR,2014-15,G,Campbell,Big South,32,1071,123,271,40,73,83,198,33,43,36,120,156,61,25,2,26,70,362
604,Christian Sengfelder,FR,2014-15,F,Fordham,A-10,31,1049,136,275,99,161,37,114,53,80,64,155,219,21,16,13,50,95,362
605,Malcolm Smith,SR,2014-15,F,Lipscomb,A-Sun,25,641,107,232,99,208,8,24,140,191,50,77,127,39,20,3,60,65,362
606,Parker Wentz,JR,2014-15,G,Abilene Christian,Southland,31,894,110,262,48,114,62,148,80,94,8,55,63,44,48,3,45,64,362
607,Arnold Fripp,SR,2014-15,F,Coppin State,MEAC,31,834,134,321,82,179,52,142,41,55,46,127,173,20,15,29,41,84,361
608,Hugh Greenwood,SR,2014-15,G,New Mexico,MWC,31,1094,121,345,49,134,72,211,47,62,18,147,165,101,47,21,58,60,361
609,Lonnie McClanahan,SR,2014-15,G,Texas-Arlington,Sun Belt,31,762,118,261,118,256,0,5,125,168,27,81,108,92,32,1,87,73,361
610,Alex Mitola,JR,2014-15,G,Dartmouth,Ivy,29,999,113,295,42,101,71,194,64,75,11,66,77,79,23,0,37,36,361
611,Andre Smith,SR,2014-15,G,Winthrop,Big South,32,989,122,327,58,139,64,188,53,63,7,76,83,137,41,3,61,44,361
612,Thomas Gipson,SR,2014-15,F,Kansas State,Big 12,32,920,118,215,118,215,0,0,124,163,57,111,168,14,15,18,52,89,360
613,Kory Holden,FR,2014-15,G,Delaware,CAA,29,990,117,296,93,232,24,64,102,135,16,74,90,144,16,4,95,58,360
614,ShawnDre' Jones,FR,2014-15,G,Richmond,A-10,35,999,123,292,59,122,64,170,50,69,9,31,40,90,34,2,39,64,360
615,Jaron Nash,SR,2014-15,F,North Dakota,Big Sky,29,787,139,287,128,241,11,46,71,123,45,138,183,21,26,16,41,65,360
616,Trent Wiederman,SR,2014-15,F,Georgia Southern,Sun Belt,31,899,145,296,140,275,5,21,65,93,67,107,174,32,22,31,53,60,360
617,Trelun Banks,SO,2014-15,G,Southern,SWAC,35,1055,125,342,91,233,34,109,75,119,12,66,78,81,38,1,80,91,359
618,D.J. Mason,JR,2014-15,F,Campbell,Big South,32,845,144,286,131,249,13,37,58,104,64,102,166,64,22,30,44,75,359
619,Sean Sellers,FR,2014-15,F,Ball State,MAC,30,889,110,249,44,98,66,151,73,90,22,65,87,37,9,10,47,54,359
620,James Webb,SO,2014-15,F,Boise State,MWC,32,886,137,248,90,133,47,115,38,58,63,194,257,19,36,20,31,81,359
621,Austin Nichols,SO,2014-15,F,Memphis,AAC,27,796,151,304,149,295,2,9,54,89,54,111,165,26,21,93,38,50,358
622,Sam Thompson,SR,2014-15,F,Ohio State,Big Ten,35,1139,135,290,113,206,22,84,66,96,32,103,135,63,46,33,44,70,358
623,Reggie Upshaw,SO,2014-15,F,Middle Tennessee,CUSA,36,1048,131,298,116,246,15,52,81,125,68,183,251,57,35,35,65,81,358
624,DeVaughn Akoon-Purcell,JR,2014-15,G,Illinois State,MVC,28,734,118,278,88,188,30,90,91,118,50,108,158,37,28,5,54,52,357
625,John Brisco,SR,2014-15,G,Prairie View,SWAC,32,839,129,288,80,174,49,114,50,70,19,59,78,35,53,1,51,71,357
626,Torrion Brummitt,JR,2014-15,F,Western Carolina,Southern,32,833,130,281,129,264,1,17,96,141,70,132,202,37,31,31,77,121,357
627,Nick Coppola,SO,2014-15,G,Louisiana-Monroe,Sun Belt,38,1384,125,304,67,155,58,149,49,68,7,111,118,141,34,1,69,68,357
628,Keon Johnson,SO,2014-15,G,Winthrop,Big South,31,878,109,271,58,130,51,141,88,106,9,66,75,59,21,0,37,65,357
629,Tanner Leissner,FR,2014-15,F,New Hampshire,AEC,29,899,117,261,91,187,26,74,97,135,60,149,209,31,20,19,59,60,357
630,Dylan Ennis,JR,2014-15,G,Villanova,Big East,36,1013,123,295,65,135,58,160,52,84,33,99,132,126,35,16,64,78,356
631,Christavious Gill,SO,2014-15,G,New Orleans,Southland,29,915,117,290,69,141,48,149,74,99,13,45,58,51,39,1,42,45,356
632,Chris Jones,SR,2014-15,G,Louisville,ACC,26,807,114,301,75,186,39,115,89,122,29,74,103,94,53,1,60,68,356
633,Malcolm Riley,JR,2014-15,F,Texas Southern,SWAC,35,1023,119,238,94,180,25,58,93,125,68,156,224,19,35,4,30,72,356
634,David Samuels,SR,2014-15,F,Long Beach State,Big West,33,881,135,267,129,246,6,21,80,128,95,149,244,40,17,23,69,91,356
635,Ronrico White,SR,2014-15,G,Chattanooga,Southern,32,1006,108,282,46,107,62,175,78,103,13,69,82,104,23,3,48,55,356
636,Chris Harrison-Docks,SO,2014-15,G,Western Kentucky,CUSA,32,1077,111,296,37,87,74,209,59,78,4,82,86,80,23,0,67,53,355
637,Youssou Ndoye,SR,2014-15,C,St. Bonaventure,A-10,30,957,111,236,111,235,0,1,133,187,99,203,302,27,20,78,85,88,355
638,Joshua Smith,SR,2014-15,C,Georgetown,Big East,33,677,131,211,131,211,0,0,93,144,84,106,190,39,34,22,67,115,355
639,Reed Timmer,FR,2014-15,G,Drake,MVC,31,926,118,272,92,199,26,73,93,108,8,62,70,74,16,1,58,38,355
640,Paul Watson,SO,2014-15,G-F,Fresno State,MWC,32,1066,121,307,71,166,50,141,63,90,25,131,156,24,29,23,41,87,355
641,Tucker Haymond,SO,2014-15,G-F,Western Michigan,MAC,30,841,121,244,86,147,35,97,77,103,46,83,129,54,23,2,56,56,354
642,Jake Bittle,JR,2014-15,G,South Dakota State,Summit,35,1019,119,223,85,140,34,83,81,101,47,105,152,96,41,9,60,97,353
643,Kaleb Tarczewski,JR,2014-15,C,Arizona,Pac-12,38,988,123,215,123,215,0,0,107,153,62,137,199,13,17,22,53,116,353
644,Tim Marshall,JR,2014-15,G,Virginia Military Institute,Southern,30,666,118,331,32,62,86,269,30,42,23,59,82,32,28,1,33,78,352
645,QJ Peterson,SO,2014-15,G,Virginia Military Institute,Southern,18,572,108,314,64,155,44,159,92,112,27,62,89,72,29,4,65,34,352
646,Aqeel Quinn,SR,2014-15,G,San Diego State,MWC,33,868,124,298,70,150,54,148,50,71,20,71,91,51,33,1,43,62,352
647,Brenton Scott,FR,2014-15,G,Indiana State,MVC,31,889,113,264,54,131,59,133,67,90,18,93,111,51,31,1,69,55,352
648,Austin Tillotson,JR,2014-15,G,Colgate,Patriot,33,1100,130,274,86,168,44,106,48,70,10,55,65,134,40,1,67,73,352
649,Deshawn Delaney,SR,2014-15,G,New Mexico,MWC,30,871,135,273,119,230,16,43,65,98,47,112,159,60,39,18,51,49,351
650,Nicholas Paulos,SR,2014-15,G-F,North Carolina-Greensboro,Southern,33,1178,120,264,29,54,91,210,20,27,14,112,126,54,25,11,52,61,351
651,Braylon Rayson,SO,2014-15,G,Central Michigan,MAC,32,754,118,285,62,127,56,158,59,66,27,68,95,34,30,1,37,61,351
652,P.J. Horgan,SR,2014-15,F,Citadel,Southern,30,937,131,240,131,240,0,0,88,127,73,123,196,27,17,32,60,65,350
653,Chris Olivier,JR,2014-15,F,Eastern Illinois,OVC,27,634,135,249,135,249,0,0,80,143,44,98,142,27,13,38,40,66,350
654,JayVaughn Pinkston,SR,2014-15,F,Villanova,Big East,36,933,102,225,102,219,0,6,146,188,70,124,194,41,29,29,60,76,350
655,Dwan Caldwell,SR,2014-15,C,Tennessee Tech,OVC,30,792,138,287,131,269,7,18,66,90,60,98,158,19,17,15,57,83,349
656,Willie Cauley-Stein,JR,2014-15,F,Kentucky,SEC,39,1012,135,236,135,236,0,0,79,128,89,162,251,38,47,67,48,78,349
657,Sean Gardner,JR,2014-15,G,Arkansas State,Sun Belt,29,897,129,310,75,158,54,152,37,51,32,64,96,35,33,8,43,64,349
658,Tyler Hood,SR,2014-15,F,Samford,Southern,32,874,120,261,51,88,69,173,40,44,20,88,108,41,20,12,33,90,349
659,Kasey Shepherd,JR,2014-15,G,Louisiana-Lafayette,Sun Belt,36,713,119,271,66,124,53,147,58,69,20,74,94,82,63,6,68,46,349
660,Tevonn Walker,FR,2014-15,G,Valparaiso,Horizon,34,920,119,268,92,189,27,79,84,117,37,78,115,57,37,3,52,62,349
661,Spencer Weisz,SO,2014-15,F,Princeton,Ivy,30,963,113,243,62,118,51,125,72,89,19,128,147,78,32,8,64,66,349
662,Bryce Dejean-Jones,SR,2014-15,G,Iowa State,Big 12,33,760,119,250,92,168,27,82,83,115,39,116,155,70,35,10,49,57,348
663,Bronson Koenig,SO,2014-15,G,Wisconsin,Big Ten,40,1152,115,278,53,125,62,153,56,69,19,51,70,98,9,8,33,64,348
664,Joe McDonald,JR,2014-15,G,George Washington,A-10,35,1103,122,287,81,177,41,110,63,115,65,137,202,110,43,2,61,75,348
665,Kaheem Ransom,SR,2014-15,G,Sam Houston State,Southland,35,1004,101,287,38,95,63,192,83,100,34,120,154,141,44,4,61,89,348
666,Kaj-Bjorn Sherman,SR,2014-15,C,Texas-San Antonio,CUSA,29,870,114,201,114,201,0,0,120,156,81,122,203,32,23,15,49,73,348
667,Jimmie Taylor,SO,2014-15,G,Rider,MAAC,33,980,119,297,65,162,54,135,56,88,43,100,143,36,31,6,48,88,348
668,Julian DeBose,JR,2014-15,G,Florida Gulf Coast,A-Sun,30,932,128,296,95,192,33,104,58,81,36,82,118,41,28,23,41,69,347
669,Garrett Nevels,SR,2014-15,G,Hawaii,Big West,32,984,131,320,83,181,48,139,37,48,37,105,142,43,24,12,37,62,347
670,DeVon Barnett,SO,2014-15,F,Sacred Heart,NEC,32,813,141,247,141,246,0,1,64,100,54,100,154,28,26,18,47,97,346
671,Trey Davis,JR,2014-15,G,Massachusetts,A-10,32,982,110,288,63,134,47,154,79,96,20,69,89,121,32,3,64,65,346
672,Nana Fouland,FR,2014-15,C,Bucknell,Patriot,34,829,141,257,141,257,0,0,64,115,73,112,185,23,15,37,48,89,346
673,Till Gloger,JR,2014-15,F,Maine,AEC,30,795,140,266,140,265,0,1,66,85,38,107,145,22,18,8,56,66,346
674,Jay Hook,SR,2014-15,G,Tulane,AAC,31,928,111,270,40,88,71,182,53,66,32,125,157,27,26,4,35,57,346
675,Timmy Knipp,JR,2014-15,G,Eastern Kentucky,OVC,33,975,114,272,41,81,73,191,45,54,21,104,125,61,29,40,50,64,346
676,Rashad Madden,SR,2014-15,G,Arkansas,SEC,36,980,100,236,54,114,46,122,100,116,31,101,132,164,29,5,84,80,346
677,James Miller,SO,2014-15,G-F,Howard,MEAC,30,770,125,248,106,195,19,53,77,107,23,59,82,27,31,7,64,68,346
678,Darius Gardner,SR,2014-15,G,American,Patriot,33,1272,120,262,84,179,36,83,69,93,26,76,102,130,67,5,85,76,345
679,Jay Harris,SR,2014-15,G,Tennessee State,OVC,31,884,117,297,57,151,60,146,51,73,23,73,96,69,36,1,75,75,345
680,Naz Long,JR,2014-15,G,Iowa State,Big 12,34,934,114,254,37,57,77,197,40,53,6,94,100,68,27,3,47,72,345
681,George Marshall,JR,2014-15,G,South Dakota State,Summit,26,896,114,289,50,137,64,152,53,73,4,93,97,59,19,2,54,53,345
682,Deron Powers,JR,2014-15,G,Hampton,MEAC,34,1111,107,277,67,156,40,121,91,108,27,79,106,128,41,2,55,77,345
683,Lee Skinner,JR,2014-15,F,Wofford,Southern,35,1035,130,261,129,258,1,3,84,122,56,145,201,72,26,4,54,76,345
684,Myles Turner,FR,2014-15,F,Texas,Big 12,34,755,117,257,100,195,17,62,94,112,44,178,222,20,10,89,47,82,345
685,Devonte Upson,SR,2014-15,F-C,Southeastern Louisiana,Southland,32,1031,145,239,145,239,0,0,55,89,81,157,238,18,24,49,61,94,345
686,Hans Brase,JR,2014-15,F,Princeton,Ivy,30,932,108,255,57,107,51,148,77,97,42,184,226,63,17,14,57,82,344
687,Tony Hicks,JR,2014-15,G,Pennsylvania,Ivy,26,715,114,283,71,167,43,116,73,94,12,79,91,65,22,0,83,77,344
688,Charlie Lee,SR,2014-15,G,Cleveland State,Horizon,26,931,108,226,49,105,59,121,69,79,16,64,80,105,22,1,57,60,344
689,Divine Myles,FR,2014-15,G,Stetson,A-Sun,31,939,128,319,107,253,21,66,67,99,20,94,114,106,36,7,52,62,344
690,Jabari Peters,SR,2014-15,G,Sam Houston State,Southland,35,1017,107,260,55,104,52,156,78,110,40,122,162,81,48,11,64,50,344
691,Desmond Washington,SR,2014-15,G,Saint Peter's,MAAC,25,827,98,261,65,148,33,113,115,136,11,85,96,34,31,1,42,41,344
692,Sekou Wiggs,SO,2014-15,G,Idaho,Big Sky,30,790,115,253,107,225,8,28,106,143,26,85,111,81,17,7,61,70,344
693,Aaron Bacote,JR,2014-15,G,Old Dominion,CUSA,35,955,101,267,63,147,38,120,103,122,23,84,107,95,24,1,47,58,343
694,Cazmon Hayes,SO,2014-15,G,Delaware,CAA,30,838,111,281,61,128,50,153,71,103,17,80,97,29,27,3,37,56,343
695,Jehvon Clarke,SR,2014-15,G,Bowling Green State,MAC,32,771,121,280,79,165,42,115,58,72,27,70,97,50,27,1,47,41,342
696,Brian Darden,JR,2014-15,G,Hampton,MEAC,35,833,93,261,24,68,69,193,87,103,7,52,59,34,19,1,44,77,342
697,Dante Holmes,JR,2014-15,G,North Carolina Central,MEAC,33,934,123,302,75,164,48,138,48,83,34,120,154,78,44,1,60,113,342
698,Jaleen Smith,SO,2014-15,G,New Hampshire,AEC,32,1014,110,264,79,170,31,94,91,113,26,140,166,90,43,11,72,85,342
699,Will Sullivan,SR,2014-15,G,Miami (OH),MAC,32,1034,109,225,41,72,68,153,56,69,28,127,155,47,28,1,43,51,342
700,Thomas van der Mars,SR,2014-15,C,Portland,WCC,33,866,138,260,138,260,0,0,66,108,90,175,265,18,17,48,47,87,342
701,Jackson Kent,SO,2014-15,G,James Madison,CAA,33,1050,108,259,48,116,60,143,65,82,14,106,120,55,28,0,49,38,341
702,Cedrick Lang,SR,2014-15,F,Texas-El Paso,CUSA,33,883,114,184,114,183,0,1,113,173,78,143,221,59,16,17,51,111,341
703,Austin Price,SO,2014-15,G,Lehigh,Patriot,30,847,119,275,74,158,45,117,58,73,22,68,90,59,46,11,58,65,341
704,Shivaughn Wiggins,SO,2014-15,G,Coastal Carolina,Big South,34,1059,105,231,88,182,17,49,114,161,12,82,94,111,41,3,42,59,341
705,Markus Crider,JR,2014-15,F,Georgia State,Sun Belt,35,1104,141,237,141,235,0,2,58,86,58,167,225,64,44,12,58,113,340
706,Jett Raines,JR,2014-15,F,Pepperdine,WCC,32,913,133,272,121,233,12,39,62,79,45,117,162,16,21,22,31,67,340
707,Devante Wallace,SR,2014-15,G,High Point,Big South,33,913,116,267,52,105,64,162,44,59,45,139,184,46,31,18,44,65,340
708,Julian Washburn,SR,2014-15,F-G,Texas-El Paso,CUSA,33,1117,127,306,87,201,40,105,46,64,29,107,136,86,29,19,42,63,340
709,Gabe York,JR,2014-15,G,Arizona,Pac-12,37,856,107,243,41,78,66,165,60,74,6,71,77,45,22,13,37,45,340
710,Taylor Barnette,SO,2014-15,G,Belmont,OVC,32,951,121,277,37,62,84,215,13,30,5,78,83,42,26,1,26,53,339
711,Dan Garvin,SO,2014-15,F,Bryant,NEC,31,961,139,265,137,257,2,8,59,89,96,148,244,37,30,48,59,118,339
712,Greg Pryor,FR,2014-15,G,Chattanooga,Southern,30,823,105,231,61,115,44,116,85,114,14,63,77,76,41,4,60,78,339
713,Justin Roberson,JR,2014-15,G,Louisiana-Monroe,Sun Belt,38,1059,132,333,124,290,8,43,67,91,36,116,152,105,45,8,72,103,339
714,Wayne Selden,SO,2014-15,G,Kansas,Big 12,36,1060,112,293,66,167,46,126,69,105,34,67,101,95,22,19,74,75,339
715,Ryan Spangler,JR,2014-15,F,Oklahoma,Big 12,35,1088,136,234,126,201,10,33,57,79,86,202,288,46,24,38,46,87,339
716,Gary Winston,SR,2014-15,G,Portland State,Big Sky,28,884,116,282,63,158,53,124,54,66,5,58,63,104,16,1,63,53,339
717,Kaven Bernard,JR,2014-15,F,Jackson State,SWAC,32,681,126,294,110,226,16,68,70,98,62,96,158,30,16,16,44,67,338
718,Tyler Harris,JR,2014-15,F,Providence,Big East,34,908,118,280,96,203,22,77,80,109,43,94,137,34,30,7,38,81,338
719,A.J. Hess,JR,2014-15,G,Southern Utah,Big Sky,29,743,106,241,49,103,57,138,69,82,13,95,108,28,15,17,39,78,338
720,Adedeji Ibitayo,SR,2014-15,G,Akron,MAC,34,660,105,233,67,132,38,101,90,121,38,68,106,33,29,14,39,74,338
721,Mark Nwakamma,SR,2014-15,F,Hartford,AEC,28,727,137,272,129,252,8,20,56,91,46,112,158,54,33,8,71,86,338
722,Aaron Parks,SO,2014-15,G,Cal State Northridge,Big West,32,926,93,261,81,213,12,48,140,181,15,81,96,58,23,10,73,85,338
723,Devin Sibley,FR,2014-15,G,Furman,Southern,33,826,103,237,67,140,36,97,96,128,21,77,98,40,24,10,72,71,338
724,Royce Woolridge,SR,2014-15,G,Grand Canyon,WAC,32,810,110,241,90,179,20,62,98,132,9,79,88,72,29,3,71,76,338
725,Andrew Chrabascz,SO,2014-15,F,Butler,Big East,30,861,120,269,97,202,23,67,74,120,47,62,109,50,24,17,40,80,337
726,Octavius Ellis,JR,2014-15,F,Cincinnati,AAC,34,975,122,219,122,218,0,1,93,135,93,152,245,44,28,67,76,90,337
727,Montel James,JR,2014-15,F,Loyola (IL),MVC,36,764,141,265,141,265,0,0,55,98,60,96,156,23,16,23,50,47,337
728,Cedric Kuakumensah,JR,2014-15,F,Brown,Ivy,30,842,119,264,93,189,26,75,73,109,55,166,221,25,16,76,58,97,337
729,Gerrell Martin,SR,2014-15,G,Long Island University,NEC,30,795,111,281,58,146,53,135,62,75,32,79,111,20,18,2,37,34,337
730,Geovonie McKnight,JR,2014-15,G,Miami (OH),MAC,32,964,130,304,125,273,5,31,72,103,19,90,109,43,46,6,62,68,337
731,Devonta Walker,JR,2014-15,F,Louisiana-Lafayette,Sun Belt,36,752,110,218,106,207,4,11,113,141,72,117,189,38,25,13,66,70,337
732,T.J. Williams,SO,2014-15,G,Northeastern,CAA,35,1158,119,261,91,180,28,81,71,118,23,102,125,111,28,9,78,56,337
733,Mitch Bruneel,SR,2014-15,F,Utah Valley,WAC,29,971,124,248,103,174,21,74,67,98,82,93,175,28,20,4,47,53,336
734,Keelan Garrett,SR,2014-15,G,McNeese State,Southland,31,892,123,324,54,121,69,203,21,32,12,59,71,45,22,1,39,31,336
735,Cedric Jenkins,GR,2014-15,G,Southeastern Louisiana,Southland,30,770,120,307,85,169,35,138,61,81,31,62,93,54,35,7,67,48,336
736,Jonathan Williams,SO,2014-15,G,Toledo,MAC,33,983,114,270,62,126,52,144,56,77,22,91,113,56,19,2,72,61,336
737,J.C. Fuller,JR,2014-15,G,Western Illinois,Summit,28,763,124,301,94,208,30,93,57,74,8,85,93,63,11,9,57,38,335
738,Nicholas West,JR,2014-15,F,Alabama A&amp;M,SWAC,27,854,106,254,87,190,19,64,104,139,68,145,213,26,14,26,69,73,335
739,Devaugntah Williams,JR,2014-15,G,Texas Tech,Big 12,32,785,108,272,54,134,54,138,65,85,26,67,93,52,29,3,58,53,335
740,Byron Ashe,SO,2014-15,G,Mount St. Mary's,NEC,28,717,116,276,62,126,54,150,48,65,17,56,73,35,31,10,40,47,334
741,Jalen Billups,JR,2014-15,F-C,Northern Kentucky,A-Sun,30,645,142,204,142,203,0,1,50,80,71,106,177,17,13,36,50,81,334
742,B.J. Taylor,FR,2014-15,G,Central Florida,AAC,26,855,107,286,62,157,45,129,75,106,10,67,77,65,24,2,32,38,334
743,Trey Zeigler,SR,2014-15,G,Texas Christian,Big 12,33,901,126,271,126,261,0,10,82,132,63,74,137,70,26,11,65,88,334
744,Brian Bennett,JR,2014-15,F,Cal Poly,Big West,29,879,146,288,146,287,0,1,41,76,56,128,184,25,19,9,35,66,333
745,Trency Jackson,SR,2014-15,G,Western Kentucky,CUSA,32,970,107,263,55,134,52,129,67,96,23,78,101,85,32,1,55,77,333
746,Matt Lopez,SR,2014-15,C,Rider,MAAC,27,723,135,231,135,231,0,0,63,116,63,145,208,16,6,11,56,76,333
747,Isaiah Miles,JR,2014-15,F,Saint Joseph's,A-10,31,969,115,296,62,146,53,150,50,67,65,94,159,26,20,29,52,107,333
748,Royce O'Neale,SR,2014-15,F,Baylor,Big 12,33,1060,108,237,59,125,49,112,68,88,66,127,193,113,38,11,55,75,333
749,Kelly Oubre,FR,2014-15,G,Kansas,Big 12,36,756,110,248,76,153,34,95,79,110,41,138,179,28,41,13,43,71,333
750,David Robertson,SO,2014-15,G,North Carolina-Asheville,Big South,31,964,109,273,55,116,54,157,61,83,11,57,68,83,35,1,65,71,333
751,Kyle Anderson,SR,2014-15,G,Delaware,CAA,23,788,116,313,62,143,54,170,46,56,12,80,92,46,17,8,45,51,332
752,Justin Bibbs,FR,2014-15,G,Virginia Tech,ACC,29,863,119,279,74,170,45,109,49,75,10,77,87,52,11,1,56,61,332
753,Tekele Cotton,SR,2014-15,G,Wichita State,MVC,34,1080,122,296,89,182,33,114,55,78,24,110,134,98,47,11,45,53,332
754,Dee Davis,SR,2014-15,G,Xavier,Big East,37,1214,111,275,76,166,35,109,75,104,12,78,90,221,48,1,89,88,332
755,Bryn Forbes,JR,2014-15,G,Michigan State,Big Ten,39,1022,110,246,40,82,70,164,42,52,8,48,56,38,23,5,31,61,332
756,Daniel Ochefu,JR,2014-15,F,Villanova,Big East,36,864,130,202,130,202,0,0,72,104,95,210,305,55,31,50,66,76,332
757,Darian Anderson,FR,2014-15,G,Fairleigh Dickinson,NEC,29,846,121,312,85,210,36,102,53,77,30,72,102,86,51,5,75,82,331
758,Malcolm Duvivier,SO,2014-15,G,Oregon State,Pac-12,31,1080,110,297,80,200,30,97,81,110,20,72,92,107,38,3,84,84,331
759,Anthony Odunsi,JR,2014-15,G,Houston Baptist,Southland,27,724,92,192,85,175,7,17,140,182,14,68,82,69,25,2,82,39,331
760,Torrance Rowe,JR,2014-15,G,Tennessee Tech,OVC,29,842,107,281,55,127,52,154,65,82,14,53,67,79,26,0,59,38,331
761,Dante Williams,SR,2014-15,F,Oakland,Horizon,33,1154,118,291,51,99,67,192,28,39,31,59,90,57,26,10,43,93,331
762,Nathan Boothe,JR,2014-15,C,Toledo,MAC,33,897,131,263,119,230,12,33,56,63,51,137,188,71,24,42,51,106,330
763,Jonathan Holmes,SR,2014-15,F,Texas,Big 12,32,835,105,270,62,140,43,130,77,99,71,125,196,34,17,33,47,71,330
764,Carrington Love,JR,2014-15,G,Green Bay,Horizon,33,1031,108,284,70,158,38,126,76,110,24,82,106,101,52,7,64,64,330
765,Armani Moore,JR,2014-15,G,Tennessee,SEC,32,989,125,281,119,248,6,33,74,120,91,125,216,69,46,39,74,91,330
766,Zach Nelson,SO,2014-15,F,Utah Valley,WAC,30,901,124,267,82,141,42,126,40,57,45,139,184,67,21,35,72,77,330
767,Scoochie Smith,SO,2014-15,G,Dayton,A-10,36,1181,106,256,65,148,41,108,77,102,12,98,110,138,52,4,72,81,330
768,Nino Williams,SR,2014-15,F,Kansas State,Big 12,29,781,120,251,117,243,3,8,87,105,52,103,155,32,16,6,37,96,330
769,Drew Brandon,SR,2014-15,G,Eastern Washington,Big Sky,34,1139,113,273,91,184,22,89,81,100,67,169,236,160,61,10,62,79,329
770,Christen Cunningham,FR,2014-15,G,Samford,Southern,32,962,106,246,95,205,11,41,106,134,16,61,77,125,38,4,73,51,329
771,Pat Forsythe,JR,2014-15,C,Akron,MAC,33,732,132,236,131,231,1,5,64,108,71,91,162,32,20,42,51,80,329
772,Peter Hooley,JR,2014-15,G,Albany (NY),AEC,24,781,108,252,63,120,45,132,68,90,12,60,72,56,13,0,44,26,329
773,Ognjen Miljkovic,SO,2014-15,F,Eastern Washington,Big Sky,34,812,111,270,56,124,55,146,52,70,26,81,107,32,21,22,58,90,329
774,Jonathan Stark,SO,2014-15,G,Tulane,AAC,31,985,119,320,89,213,30,107,61,84,17,60,77,137,39,7,76,60,329
775,Aaron Bright,SR,2014-15,G,Saint Mary's (CA),WCC,30,951,102,286,58,141,44,145,80,91,9,54,63,113,15,0,68,82,328
776,Ako Kaluna,SO,2014-15,F-C,Northern Arizona,Big Sky,38,761,125,262,89,181,36,81,42,58,50,78,128,29,20,10,42,94,328
777,Kevin Punter,JR,2014-15,G,Tennessee,SEC,32,992,111,265,68,143,43,122,63,92,10,57,67,60,51,6,56,90,328
778,Troy Caupain,SO,2014-15,G,Cincinnati,AAC,34,1065,107,241,76,165,31,76,82,104,17,105,122,121,41,6,72,49,327
779,Kenny Chery,SR,2014-15,G,Baylor,Big 12,29,940,107,281,55,143,52,138,61,74,14,77,91,119,40,0,76,47,327
780,Pierria Henry,SR,2014-15,G,Charlotte,CUSA,32,1003,107,266,86,190,21,76,92,116,43,123,166,173,76,22,79,81,327
781,Tyreek Jewell,JR,2014-15,G,St. Francis (NY),NEC,35,1023,123,358,94,213,29,145,52,83,44,84,128,39,25,7,47,59,327
782,Eric Laster,JR,2014-15,G,Loyola (MD),Patriot,30,891,123,318,90,229,33,89,48,86,46,67,113,48,20,14,58,81,327
783,Luke Roh,SR,2014-15,G,Colgate,Patriot,33,1085,129,215,129,215,0,0,69,101,53,150,203,85,27,8,62,80,327
784,Khristian Smith,JR,2014-15,G-F,Indiana State,MVC,31,940,109,271,88,191,21,80,88,112,25,114,139,52,29,12,47,77,327
785,Wade Baldwin,FR,2014-15,G,Vanderbilt,SEC,35,1009,99,227,56,129,43,98,85,106,17,128,145,155,50,4,67,86,326
786,Josiah Heath,SR,2014-15,F,Canisius,MAAC,33,850,135,263,135,258,0,5,56,99,88,135,223,40,30,35,37,89,326
787,Casey Kasperbauer,JR,2014-15,G,South Dakota,Summit,33,985,105,242,27,62,78,180,38,41,6,73,79,26,24,2,30,35,326
788,Dewayne Russell,JR,2014-15,G,Grand Canyon,WAC,23,769,103,250,89,208,14,42,106,140,9,59,68,90,32,2,49,62,326
789,Justin Tuoyo,SO,2014-15,F,Chattanooga,Southern,32,923,119,221,117,213,2,8,86,135,93,112,205,25,25,104,47,107,326
790,Jordan Woodard,SO,2014-15,G,Oklahoma,Big 12,35,1118,90,249,73,182,17,67,129,154,15,108,123,134,55,4,81,61,326
791,Tavon Allen,JR,2014-15,G,Drexel,CAA,29,951,109,346,66,194,43,152,64,80,15,73,88,68,24,18,60,74,325
792,A.J. Jacobson,FR,2014-15,G,North Dakota State,Summit,28,919,99,240,45,106,54,134,73,89,14,103,117,49,12,7,42,79,325
793,Gabas Maldunas,SR,2014-15,F-C,Dartmouth,Ivy,29,814,126,256,126,255,0,1,73,127,65,131,196,45,35,54,70,93,325
794,Lorenzo Cugini,JR,2014-15,F,High Point,Big South,33,956,116,224,61,102,55,122,37,42,34,125,159,33,7,3,26,49,324
795,Cody Demps,JR,2014-15,G,Sacramento State,Big Sky,33,1104,109,217,103,192,6,25,100,125,44,125,169,108,33,12,62,83,324
796,Tyler Hubbard,JR,2014-15,G,Loyola (MD),Patriot,30,917,99,270,35,97,64,173,62,80,14,44,58,24,17,1,31,61,324
797,Brandon Venturini,SR,2014-15,G,Navy,Patriot,27,836,114,293,49,105,65,188,31,37,6,97,103,82,39,2,71,59,324
798,Antonius Cleveland,FR,2014-15,G,Southeast Missouri State,OVC,30,871,120,254,108,197,12,57,71,125,41,102,143,55,38,15,39,73,323
799,Adonys Henriquez,FR,2014-15,G,Central Florida,AAC,30,1050,107,250,42,85,65,165,44,56,21,78,99,64,19,6,46,29,323
800,Nate Mason,FR,2014-15,G,Minnesota,Big Ten,33,862,115,281,73,173,42,108,51,83,17,77,94,92,59,3,36,58,323
801,Earl Peterson,JR,2014-15,G,Loyola (IL),MVC,37,935,109,218,88,161,21,57,84,107,8,62,70,75,31,4,68,56,323
802,Badou Diagne,JR,2014-15,F,Coastal Carolina,Big South,34,936,114,233,85,166,29,67,65,99,67,181,248,24,26,33,67,90,322
803,Jesse Morgan,SR,2014-15,G,Temple,AAC,27,786,107,307,39,115,68,192,40,49,31,60,91,36,32,7,20,35,322
804,Mike Thorne,JR,2014-15,C,Charlotte,CUSA,32,836,134,251,134,250,0,1,54,101,85,150,235,25,4,29,42,75,322
805,David Andoh,JR,2014-15,F,Liberty,Big South,32,821,123,290,123,282,0,8,75,97,65,113,178,18,14,12,84,76,321
806,Michael Martin,JR,2014-15,G,Central Arkansas,Southland,28,927,112,266,71,156,41,110,56,70,12,94,106,120,53,3,97,86,321
807,DeAngelo Priar,SR,2014-15,G,Mississippi Valley State,SWAC,32,962,109,300,71,177,38,123,65,114,42,115,157,64,37,7,76,67,321
808,Ramone Snowden,SO,2014-15,F,Niagara,MAAC,30,980,98,252,55,126,43,126,82,131,43,136,179,70,34,14,64,84,321
809,Milik Yarbrough,FR,2014-15,F,Saint Louis,A-10,32,759,129,274,124,249,5,25,58,102,52,102,154,47,20,12,68,64,321
810,Cam Griffin,SR,2014-15,G,Denver,Summit,28,930,109,201,104,179,5,22,97,128,51,121,172,66,48,8,62,70,320
811,T.J. Hallice,SR,2014-15,F,Mercer,Southern,35,1158,127,256,124,240,3,16,63,108,91,138,229,44,27,23,36,74,320
812,Theo Johnson,JR,2014-15,G-F,Liberty,Big South,32,814,95,220,85,182,10,38,120,163,41,105,146,53,18,9,66,53,320
813,Ray Sanders,JR,2014-15,G-F,Albany (NY),AEC,33,979,100,230,68,143,32,87,88,114,44,108,152,74,45,2,58,77,320
814,Amida Brimah,SO,2014-15,C,Connecticut,AAC,35,920,126,187,126,187,0,0,67,103,69,86,155,7,7,121,36,99,319
815,Joey King,JR,2014-15,F,Minnesota,Big Ten,33,961,110,237,55,103,55,134,44,53,30,69,99,50,17,13,48,80,319
816,Jay Wright,SO,2014-15,G,Louisiana-Lafayette,Sun Belt,35,921,103,268,73,194,30,74,83,138,17,92,109,127,31,8,78,73,319
817,Donte Williams,JR,2014-15,G,Utah Valley,WAC,30,809,91,253,49,112,42,141,94,116,1,79,80,47,13,8,50,55,318
818,Justin Anderson,JR,2014-15,G,Virginia,ACC,26,724,103,221,56,117,47,104,64,82,17,88,105,45,17,14,31,30,317
819,Mo Evans,SO,2014-15,G,IPFW,Summit,31,970,107,265,53,102,54,163,49,60,14,95,109,103,30,5,58,80,317
820,Dustin Hogue,SR,2014-15,F,Iowa State,Big 12,34,892,117,210,89,145,28,65,55,100,55,111,166,38,23,11,53,86,317
821,Tonye Jekiri,JR,2014-15,C,Miami (FL),ACC,37,1120,123,246,122,245,1,1,70,96,118,248,366,42,21,51,51,114,317
822,Jon Octeus,JR,2014-15,G,Purdue,Big Ten,34,978,102,208,86,160,16,48,97,134,54,114,168,89,35,7,50,95,317
823,Devin Patterson,JR,2014-15,G,Nebraska-Omaha,Summit,27,823,104,241,77,168,27,73,82,101,19,57,76,104,59,0,83,63,317
824,Craig Sword,JR,2014-15,G,Mississippi State,SEC,28,695,97,215,70,140,27,75,96,137,12,67,79,48,29,11,71,70,317
825,Jacoby Armstrong,SO,2014-15,F,New Hampshire,AEC,32,785,124,241,122,231,2,10,66,105,49,82,131,34,12,16,54,103,316
826,Ian Baker,SO,2014-15,G,New Mexico State,WAC,34,989,98,213,40,86,58,127,62,81,9,74,83,93,50,1,74,53,316
827,Danrad Knowles,SO,2014-15,F,Houston,AAC,32,877,108,267,71,152,37,115,63,100,69,111,180,34,17,42,43,80,316
828,Joe O'Shea,SR,2014-15,G,Bryant,NEC,30,1017,95,204,62,118,33,86,93,120,52,118,170,67,25,9,41,102,316
829,J.P. Tokoto,JR,2014-15,F,North Carolina,ACC,38,1106,116,271,104,239,12,32,72,117,61,152,213,163,56,13,85,91,316
830,Dre Wills,SO,2014-15,G,Vermont,AEC,34,927,120,210,117,196,3,14,73,119,37,127,164,80,63,33,65,91,316
831,Robert Hatter,SO,2014-15,G,Cornell,Ivy,28,743,97,266,51,114,46,152,75,90,16,60,76,19,34,7,40,65,315
832,Tyrone Johnson,SR,2014-15,G,South Carolina,SEC,33,981,97,268,69,172,28,96,93,112,16,73,89,114,40,9,63,69,315
833,Devon Turk,JR,2014-15,G,Loyola (IL),MVC,37,884,106,246,28,62,78,184,25,30,12,88,100,29,28,5,35,79,315
834,Michael Frazier,JR,2014-15,G,Florida,SEC,26,759,98,235,41,85,57,150,61,70,23,84,107,37,31,2,46,44,314
835,Max Guercy,JR,2014-15,G,Rice,CUSA,32,1056,101,265,65,136,36,129,76,88,17,69,86,145,49,0,82,73,314
836,Dakarai Henderson,SO,2014-15,G,Sam Houston State,Southland,35,738,101,292,39,114,62,178,50,67,23,56,79,21,18,3,29,41,314
837,Anthony Hickey,SR,2014-15,G,Oklahoma State,Big 12,32,954,121,283,61,133,60,150,12,29,18,116,134,109,64,6,50,75,314
838,Reggie Lynch,SO,2014-15,C,Illinois State,MVC,33,731,116,228,116,228,0,0,82,120,91,87,178,8,23,93,53,122,314
839,Isaiah Taylor,SO,2014-15,G,Texas,Big 12,24,757,109,272,98,233,11,39,85,101,9,67,76,110,23,2,63,50,314
840,Jahad Thomas,FR,2014-15,G,Massachusetts-Lowell,AEC,22,706,123,235,118,221,5,14,63,100,28,114,142,34,29,3,70,59,314
841,Tiegbe Bamba,SR,2014-15,F,Portland State,Big Sky,27,822,111,202,97,163,14,39,77,112,52,131,183,30,33,5,46,66,313
842,Andell Cumberbatch,SR,2014-15,G,St. Bonaventure,A-10,31,995,114,284,76,179,38,105,47,67,34,119,153,60,36,10,55,78,313
843,Shep Garner,FR,2014-15,G,Penn State,Big Ten,34,979,104,286,45,111,59,175,46,58,17,75,92,77,33,2,48,69,313
844,Trey Lyles,FR,2014-15,F,Kentucky,SEC,36,828,117,240,113,211,4,29,75,102,65,123,188,38,19,16,41,57,313
845,Matt McMullen,SR,2014-15,F,Colgate,Patriot,33,1086,109,208,61,110,48,98,47,57,35,180,215,69,34,25,57,81,313
846,DeSean Murray,FR,2014-15,F,Presbyterian,Big South,20,661,122,235,121,231,1,4,68,115,70,93,163,32,30,10,54,55,313
847,Remy Abell,JR,2014-15,G,Xavier,Big East,37,1020,108,221,69,126,39,95,57,80,12,63,75,46,22,3,33,45,312
848,Gary Bell,SR,2014-15,G,Gonzaga,WCC,38,1058,101,250,45,95,56,155,54,72,9,84,93,76,32,5,35,90,312
849,Julian Eleby,SO,2014-15,G,Virginia Military Institute,Southern,28,700,89,242,54,127,35,115,99,127,19,107,126,78,29,3,66,55,312
850,Tyler Gaskins,SR,2014-15,F,Saint Peter's,MAAC,34,937,115,280,67,153,48,127,34,61,24,57,81,58,28,4,63,69,312
851,Derrick Gordon,JR,2014-15,G,Massachusetts,A-10,32,910,108,268,107,256,1,12,95,129,36,120,156,85,49,14,79,42,312
852,Kahron Ross,FR,2014-15,G,Lehigh,Patriot,30,948,97,243,74,172,23,71,95,119,25,59,84,175,37,3,70,69,312
853,James Siakam,SR,2014-15,F,Vanderbilt,SEC,34,827,99,158,97,155,2,3,112,148,91,110,201,22,33,42,44,102,312
854,Isaac Williams,SO,2014-15,G,Mississippi Valley State,SWAC,32,731,107,299,64,171,43,128,55,64,37,100,137,29,19,4,51,51,312
855,Aaric Armstead,SO,2014-15,G,Northern Illinois,MAC,28,807,100,244,79,183,21,61,90,128,39,92,131,18,40,10,47,51,311
856,Roderick Bobbitt,JR,2014-15,G,Hawaii,Big West,35,1155,94,245,67,138,27,107,96,131,32,88,120,187,100,7,96,102,311
857,Daniel Dixon,SO,2014-15,G,William &amp; Mary,CAA,28,812,102,232,29,70,73,162,34,42,6,72,78,32,23,9,31,70,311
858,D.J. Felder,SR,2014-15,F,Jacksonville State,OVC,31,715,122,289,110,252,12,37,55,80,58,111,169,23,12,21,40,83,311
859,Malik Harmon,SO,2014-15,G,Saint Francis (PA),NEC,32,1002,101,255,58,124,43,131,66,101,3,66,69,85,37,3,56,76,311
860,Tim Huskisson,SR,2014-15,F,Northern Colorado,Big Sky,29,623,109,189,89,136,20,53,73,101,50,65,115,36,27,12,46,97,311
861,Nino Johnson,SR,2014-15,F,Southeast Missouri State,OVC,30,874,123,228,123,227,0,1,65,126,70,141,211,36,41,64,63,89,311
862,Michale Kyser,SR,2014-15,F,Louisiana Tech,CUSA,36,1022,127,209,127,209,0,0,57,94,79,157,236,15,23,102,29,96,311
863,Jakob Poeltl,FR,2014-15,F,Utah,Pac-12,34,792,128,188,128,187,0,1,55,124,92,138,230,23,12,63,55,82,311
864,Devon Walker,SR,2014-15,G,Maryland-Eastern Shore,MEAC,33,916,107,248,35,65,72,183,25,31,15,84,99,32,21,8,27,72,311
865,Terrence Williams,SR,2014-15,G,Charlotte,CUSA,32,826,104,246,79,183,25,63,78,109,33,105,138,70,28,3,72,85,311
866,Jeremy Combs,FR,2014-15,F,North Texas,CUSA,31,794,120,214,120,214,0,0,70,144,79,130,209,10,29,22,40,90,310
867,Reese Holliday,SR,2014-15,F,Missouri-Kansas City,WAC,32,831,93,215,62,133,31,82,93,122,44,115,159,38,24,4,64,69,310
868,Reggie Johnson,JR,2014-15,G,Hampton,MEAC,26,722,104,281,65,168,39,113,63,106,33,53,86,43,36,7,39,54,310
869,Max Yon,SR,2014-15,G,Air Force,MWC,25,706,112,242,70,129,42,113,44,68,8,51,59,56,13,4,51,36,310
870,Ja'Dante' Frye,FR,2014-15,F,Nicholls State,Southland,29,797,116,229,115,220,1,9,76,108,38,57,95,26,28,6,50,42,309
871,Riley Grabau,SR,2014-15,G,Wyoming,MWC,34,1154,78,207,17,41,61,166,92,98,5,70,75,73,8,3,48,53,309
872,Franko House,SO,2014-15,F,Ball State,MAC,30,861,110,219,107,193,3,26,86,122,61,104,165,72,28,15,65,106,309
873,Dominique Lee,SR,2014-15,F,Northern Colorado,Big Sky,30,776,118,196,111,179,7,17,66,105,82,140,222,26,36,27,31,93,309
874,A.J. Merriweather,SO,2014-15,G,East Tennessee State,Southern,30,816,112,232,92,183,20,49,65,90,57,127,184,41,39,10,58,79,309
875,Konstantinos Mitoglou,FR,2014-15,F,Wake Forest,ACC,32,713,103,233,51,98,52,135,51,71,52,94,146,13,16,19,35,65,309
876,DeMarcus Robinson,SR,2014-15,G,Alabama State,SWAC,29,870,110,254,59,133,51,121,38,51,21,57,78,61,34,2,36,44,309
877,Jarvis Davis,SR,2014-15,G,Gardner-Webb,Big South,35,842,99,235,43,82,56,153,54,62,17,103,120,31,39,2,39,68,308
878,Kevin Hill,JR,2014-15,F,New Orleans,Southland,29,704,105,230,105,230,0,0,98,131,66,127,193,20,17,22,64,62,308
879,Marek Olesinski,SR,2014-15,F,Air Force,MWC,31,928,112,222,67,107,45,115,39,56,39,108,147,56,23,9,34,50,308
880,Andrew Smith,SR,2014-15,F,Liberty,Big South,32,858,130,245,130,238,0,7,48,73,82,160,242,28,34,40,57,97,308
881,Jae'Sean Tate,FR,2014-15,F,Ohio State,Big Ten,35,771,126,214,123,195,3,19,53,102,66,109,175,12,31,21,42,88,308
882,Donte Clark,FR,2014-15,G,Massachusetts,A-10,32,742,91,233,62,145,29,88,96,126,21,58,79,63,22,7,42,66,307
883,Bryce Douvier,JR,2014-15,F,Texas A&amp;M-Corpus Christi,Southland,34,859,103,226,69,142,34,84,67,81,47,149,196,19,13,12,55,110,307
884,Brandon Goodwin,SO,2014-15,G,Central Florida,AAC,30,1013,108,247,91,182,17,65,74,122,36,81,117,127,37,4,88,59,307
885,Trent Mackey,JR,2014-15,G,North Florida,A-Sun,35,903,93,210,12,24,81,186,40,46,10,47,57,50,17,2,30,74,307
886,Patrick McCaw,FR,2014-15,G,Nevada-Las Vegas,MWC,32,947,105,261,48,106,57,155,40,56,23,81,104,86,48,10,57,49,307
887,Marin Mornar,JR,2014-15,F,Loyola Marymount,WCC,31,829,113,220,96,170,17,50,64,87,62,102,164,24,4,47,40,72,307
888,Tyler Nelson,FR,2014-15,G,Fairfield,MAAC,30,815,97,229,33,78,64,151,49,57,14,44,58,41,21,0,40,39,307
889,Steven Spieth,SO,2014-15,G,Brown,Ivy,31,1000,89,230,72,158,17,72,112,138,35,111,146,65,32,17,69,78,307
890,Jonathan Arledge,SR,2014-15,F,Old Dominion,CUSA,35,704,115,264,99,204,16,60,60,98,63,108,171,21,20,19,49,89,306
891,Deverell Biggs,SR,2014-15,G,Texas Southern,SWAC,26,753,112,240,84,168,28,72,54,70,13,73,86,50,43,6,69,64,306
892,Braxton Ogbueze,SO,2014-15,G,Charlotte,CUSA,32,899,97,245,48,124,49,121,63,76,19,54,73,54,30,1,37,55,306
893,Jorge Rosa,FR,2014-15,G,Florida A&amp;M,MEAC,27,809,96,276,41,108,55,168,59,83,17,56,73,18,19,3,42,41,306
894,Andre Walker,FR,2014-15,G,Loyola (MD),Patriot,30,838,97,305,77,219,20,86,92,117,33,91,124,68,52,4,71,90,306
895,Isaiah Williams,JR,2014-15,G,Iona,MAAC,23,798,107,213,38,57,69,156,23,31,42,98,140,51,33,32,24,67,306
896,Bogdan Bliznyuk,FR,2014-15,F,Eastern Washington,Big Sky,35,665,112,191,88,148,24,43,57,72,45,96,141,39,19,14,47,84,305
897,Brian Brown,SR,2014-15,G,Virginia Military Institute,Southern,28,754,106,264,31,71,75,193,18,21,10,43,53,51,32,2,52,39,305
898,Zack Denny,SO,2014-15,G,Bowling Green State,MAC,33,896,105,252,55,125,50,127,45,53,42,131,173,31,53,5,38,60,305
899,Worth Smith,SR,2014-15,F,Navy,Patriot,21,665,126,262,101,204,25,58,28,36,38,85,123,23,27,21,31,44,305
900,Jared Terrell,FR,2014-15,G,Rhode Island,A-10,33,893,105,283,75,189,30,94,65,91,15,65,80,49,46,5,58,105,305
901,Tyler White,JR,2014-15,G,Northern Kentucky,A-Sun,30,833,109,274,43,99,66,175,21,34,10,48,58,35,16,5,27,66,305
902,Alex Barlow,SR,2014-15,G,Butler,Big East,34,1154,98,243,41,90,57,153,51,61,16,120,136,88,74,2,64,103,304
903,Auston Barnes,SR,2014-15,F,Bradley,MVC,31,993,100,253,54,121,46,132,58,65,43,105,148,29,34,16,53,75,304
904,J.J. Frazier,SO,2014-15,G,Georgia,SEC,32,943,84,212,34,85,50,127,86,104,23,100,123,104,37,5,48,72,304
905,Mark Gary,JR,2014-15,F,Grambling,SWAC,29,783,91,217,74,174,17,43,105,139,53,118,171,20,13,9,84,69,304
906,Martin Hermannsson,FR,2014-15,G,Long Island University,NEC,30,937,90,230,68,150,22,80,102,118,18,97,115,100,27,5,73,83,304
907,Luke Kornet,SO,2014-15,C,Vanderbilt,SEC,35,756,106,214,56,89,50,125,42,55,32,88,120,37,7,38,41,67,304
908,LaDarrien Williams,SR,2014-15,G,Abilene Christian,Southland,31,747,110,276,78,183,32,93,52,62,30,105,135,62,28,3,64,71,304
909,Tavon Blackmon,SO,2014-15,G,Brown,Ivy,29,939,97,252,79,190,18,62,91,111,17,45,62,114,18,2,94,69,303
910,Jordan Caroline,FR,2014-15,F,Southern Illinois,MVC,33,844,100,223,98,220,2,3,101,153,79,127,206,29,23,8,53,68,303
911,Justin Edmonds,JR,2014-15,G,Marshall,CUSA,31,713,98,253,44,100,54,153,53,87,19,63,82,41,24,3,56,50,303
912,Charles Mitchell,JR,2014-15,F,Georgia Tech,ACC,31,684,124,238,124,238,0,0,55,83,109,109,218,12,11,14,66,79,303
913,Nehemias Morillo,JR,2014-15,G,South Florida,AAC,30,838,117,278,80,162,37,116,32,43,31,99,130,38,20,7,64,69,303
914,Gary Ricks,SR,2014-15,G,Drake,MVC,28,838,106,251,42,97,64,154,27,35,6,80,86,57,22,2,28,52,303
915,Peyton Aldridge,FR,2014-15,F,Davidson,A-10,32,972,111,241,68,130,43,111,37,53,58,105,163,49,13,35,26,93,302
916,Gian Clavell,JR,2014-15,G,Colorado State,MWC,33,813,90,241,46,95,44,146,78,116,10,112,122,41,33,14,37,72,302
917,Steven Cook,SO,2014-15,F,Princeton,Ivy,29,835,95,215,51,103,44,112,68,91,21,78,99,44,45,10,51,62,302
918,Dylan Cox,JR,2014-15,G,Army,Patriot,30,834,111,203,106,173,5,30,75,113,44,96,140,144,33,7,75,80,302
919,Xavier Ford,SR,2014-15,F,Buffalo,MAC,31,718,110,235,91,179,19,56,63,91,75,117,192,18,33,16,47,88,302
920,Robert Johnson,FR,2014-15,G,Indiana,Big Ten,34,917,111,259,59,125,52,134,28,43,14,85,99,79,29,1,71,65,302
921,Marc Loving,SO,2014-15,F,Ohio State,Big Ten,32,759,96,209,49,107,47,102,63,82,40,76,116,20,16,10,37,67,302
922,Joey Ptasinski,SR,2014-15,G,Lafayette,Patriot,32,967,104,218,32,57,72,161,22,24,9,78,87,58,39,4,26,57,302
923,Alex Caruso,JR,2014-15,G,Texas A&amp;M,SEC,33,1038,106,229,80,158,26,71,63,92,24,126,150,182,69,2,100,67,301
924,Nick Duncan,SO,2014-15,F,Boise State,MWC,32,1004,98,246,22,48,76,198,29,35,24,87,111,30,20,14,26,90,301
925,Tommy Hamilton,SO,2014-15,C,DePaul,Big East,30,773,103,201,80,152,23,49,72,107,42,117,159,30,16,24,65,65,301
926,Cornell Johnson,FR,2014-15,G,Eastern Illinois,OVC,33,1144,95,222,40,116,55,106,56,65,13,50,63,156,25,0,85,51,301
927,James Robinson,JR,2014-15,G,Pittsburgh,ACC,34,1152,94,256,66,162,28,94,85,102,16,106,122,174,36,8,56,81,301
928,Reed Tellinghuisen,FR,2014-15,G-F,South Dakota State,Summit,35,823,102,225,44,87,58,138,39,57,25,92,117,34,20,19,41,81,301
929,Gavin Ware,JR,2014-15,F,Mississippi State,SEC,30,803,110,220,110,220,0,0,81,109,62,150,212,9,11,32,45,70,301
930,Jaleel Williams,SR,2014-15,F,San Jose State,MWC,27,870,110,265,59,116,51,149,30,53,28,99,127,22,13,5,41,46,301
931,Antonio Campbell,SO,2014-15,F,Ohio,MAC,30,722,121,250,93,168,28,82,30,48,57,172,229,19,14,27,36,99,300
932,Devin Cherry,SR,2014-15,G,Cornell,Ivy,30,1001,96,257,67,158,29,99,79,109,10,110,120,103,25,1,98,56,300
933,Austin Cooke,JR,2014-15,F,Abilene Christian,Southland,31,902,103,233,50,110,53,123,41,52,45,142,187,28,17,2,39,86,300
934,Manu Lecomte,SO,2014-15,G,Miami (FL),ACC,38,853,92,214,40,100,52,114,64,73,11,41,52,67,18,0,43,56,300
935,Kevin Mays,JR,2014-15,F,Cal State Bakersfield,WAC,32,888,115,241,115,236,0,5,70,95,102,155,257,34,36,4,57,100,300
936,William Truss,SR,2014-15,C,Presbyterian,Big South,30,846,118,194,116,191,2,3,62,90,57,164,221,15,13,42,52,87,300
937,Marcus Tyus,JR,2014-15,G,Nebraska-Omaha,Summit,23,641,104,213,71,138,33,75,59,84,27,59,86,47,23,2,44,68,300
938,Trae Bell-Haynes,FR,2014-15,G,Vermont,AEC,34,895,84,167,71,143,13,24,118,149,17,73,90,118,31,4,105,71,299
939,Nate Frye,SO,2014-15,G,New Orleans,Southland,29,780,91,227,69,171,22,56,95,113,23,48,71,76,44,6,74,76,299
940,Shaq Goodwin,JR,2014-15,F,Memphis,AAC,31,803,112,206,107,188,5,18,70,109,80,141,221,49,20,35,61,71,299
941,Skyler Halford,SR,2014-15,G,Brigham Young,WCC,34,624,94,194,42,86,52,108,59,67,10,51,61,78,24,0,51,65,299
942,Terel Hall,SR,2014-15,G,Savannah State,MEAC,29,822,105,219,102,200,3,19,86,120,21,40,61,85,50,6,69,64,299
943,Xavier Johnson,JR,2014-15,G-F,Colorado,Pac-12,29,706,105,236,76,157,29,79,60,93,46,116,162,19,17,9,52,62,299
944,Grant Lozoya,FR,2014-15,G,Stetson,A-Sun,31,720,105,250,52,104,53,146,36,52,6,96,102,34,19,0,41,81,299
945,Shannon Scott,SR,2014-15,G,Ohio State,Big Ten,35,1068,115,279,92,198,23,81,46,62,36,90,126,207,59,4,83,55,299
946,Jabril Trawick,SR,2014-15,G,Georgetown,Big East,33,921,98,199,65,118,33,81,70,103,25,94,119,78,32,13,61,94,299
947,Richaud Gittens,SO,2014-15,G,Weber State,Big Sky,30,989,93,229,54,137,39,92,73,94,11,79,90,85,32,3,57,68,298
948,Christian Kessee,SO,2014-15,G,Coppin State,MEAC,31,723,97,241,46,113,51,128,53,68,15,47,62,50,19,2,58,80,298
949,Corban Wroe,SR,2014-15,G,Hartford,AEC,30,1036,108,234,59,97,49,137,33,44,21,101,122,73,41,3,57,89,298
950,Nate Engesser,JR,2014-15,G,Denver,Summit,29,795,108,209,56,89,52,120,29,35,8,60,68,69,21,4,35,51,297
951,Chris Golden,JR,2014-15,G,Weber State,Big Sky,30,797,95,262,32,80,63,182,44,58,7,52,59,38,28,3,42,66,297
952,Colter Lasher,SO,2014-15,F,Houston Baptist,Southland,28,631,117,246,92,170,25,76,38,48,36,68,104,43,22,4,39,68,297
953,JeQuan Lewis,SO,2014-15,G,Virginia Commonwealth,A-10,35,761,91,245,53,139,38,106,77,96,11,47,58,95,49,0,77,88,297
954,James Milliken,JR,2014-15,G,Creighton,Big East,31,811,95,234,50,117,45,117,62,79,9,73,82,56,13,0,30,51,297
955,Mike Rostampour,SR,2014-15,F,Nebraska-Omaha,Summit,29,709,100,223,89,195,11,28,86,121,85,137,222,12,25,14,56,112,297
956,Malik Thomas,SR,2014-15,G-F,Norfolk State,MEAC,32,851,107,255,68,135,39,120,44,69,39,102,141,61,16,29,34,90,297
957,Estan Tyler,JR,2014-15,G,North Dakota,Big Sky,27,812,91,223,53,119,38,104,77,94,10,57,67,61,28,3,63,63,297
958,Jordan Washington,SO,2014-15,G,Mississippi Valley State,SWAC,23,634,98,249,60,147,38,102,63,84,20,34,54,47,30,0,58,44,297
959,Siyani Chambers,JR,2014-15,G,Harvard,Ivy,30,1036,93,260,53,143,40,117,70,86,10,58,68,129,45,1,70,57,296
960,Isaac Fleming,FR,2014-15,G,Hawaii,Big West,31,715,115,244,90,147,25,97,41,64,31,65,96,66,33,4,64,70,296
961,Michael Holyfield,SR,2014-15,C,Sam Houston State,Southland,35,628,109,181,109,180,0,1,78,126,112,171,283,9,13,86,54,111,296
962,Roquez Johnson,SR,2014-15,F,Mississippi State,SEC,32,831,98,186,98,186,0,0,100,149,66,98,164,17,27,6,66,80,296
963,Rafael Maia,SR,2014-15,C,Brown,Ivy,30,903,100,186,95,167,5,19,91,167,98,162,260,54,26,18,53,86,296
964,Josh Robinson,FR,2014-15,G,Austin Peay,OVC,30,645,95,261,51,142,44,119,62,81,15,36,51,21,21,1,35,24,296
965,Kendall Stephens,SO,2014-15,G,Purdue,Big Ten,34,760,93,265,20,75,73,190,37,50,13,64,77,56,14,11,41,54,296
966,Geno Thorpe,SO,2014-15,G,Penn State,Big Ten,34,826,91,229,71,164,20,65,94,112,26,62,88,43,38,4,53,103,296
967,Marcellus Barksdale,JR,2014-15,G-F,IUPUI,Summit,31,991,99,253,86,202,13,51,84,115,28,117,145,74,52,7,68,71,295
968,Paul Baxter,JR,2014-15,G,Sam Houston State,Southland,35,951,98,247,65,153,33,94,66,97,15,78,93,92,32,5,71,101,295
969,Quintin Brewer,JR,2014-15,F,Bethune-Cookman,MEAC,32,899,113,223,107,207,6,16,63,89,77,147,224,20,25,34,69,103,295
970,T.J. Carpenter,JR,2014-15,G,Nicholls State,Southland,27,748,99,256,68,141,31,115,66,97,30,85,115,58,20,3,73,71,295
971,Brandon Gfeller,SO,2014-15,G,Montana,Big Sky,33,834,92,216,9,19,83,197,28,36,18,74,92,36,30,6,26,80,295
972,Brandon Mobley,SR,2014-15,F,Seton Hall,Big East,30,735,106,247,81,168,25,79,58,72,44,107,151,19,20,33,30,87,295
973,Dominique Reid,FR,2014-15,F,Niagara,MAAC,30,656,101,259,99,252,2,7,91,130,63,113,176,25,13,14,60,88,295
974,DJ Cole,SR,2014-15,G,Youngstown State,Horizon,32,1037,98,229,68,144,30,85,68,102,10,72,82,150,51,1,87,69,294
975,Khalil Davis,JR,2014-15,G,Austin Peay,OVC,30,905,86,245,62,164,24,81,98,156,61,86,147,77,27,8,68,74,294
976,Patrick Holloway,JR,2014-15,G,George Mason,A-10,27,712,108,277,68,156,40,121,38,46,4,29,33,20,18,0,50,54,294
977,Darius Perkins,JR,2014-15,G,Utah State,MWC,31,911,98,243,36,97,62,146,36,56,9,66,75,101,18,1,65,48,294
978,Traylin Farris,FR,2014-15,F,Incarnate Word,Southland,29,693,124,224,124,221,0,3,45,88,55,81,136,16,19,27,35,96,293
979,Javonte Maynor,SR,2014-15,G,Cal State Bakersfield,WAC,33,968,92,259,22,59,70,200,39,57,9,34,43,33,28,2,36,78,293
980,Rayshaun McGrew,JR,2014-15,F,Stony Brook,AEC,35,932,117,261,117,259,0,2,59,89,99,179,278,37,22,2,56,78,293
981,Luke Nelson,SO,2014-15,G,California-Irvine,Big West,28,820,97,272,50,117,47,155,52,72,10,72,82,111,29,3,73,55,293
982,Tilman Dunbar,JR,2014-15,G,Navy,Patriot,32,953,106,247,102,232,4,15,76,117,10,54,64,105,34,0,66,77,292
983,Tyler Strange,SR,2014-15,G,Gardner-Webb,Big South,35,1201,99,257,42,102,57,155,37,56,12,86,98,260,59,5,85,65,292
984,Achraf Yacoubou,JR,2014-15,G,Saint Louis,A-10,32,833,105,267,90,202,15,65,67,107,44,109,153,44,28,6,65,79,292
985,Karim York,JR,2014-15,F,Prairie View,SWAC,32,799,114,248,91,178,23,70,41,68,63,100,163,25,21,13,74,97,292
986,Paris Burns,JR,2014-15,G,Illinois-Chicago,Horizon,28,622,101,238,81,176,20,62,69,89,12,59,71,68,20,2,48,70,291
987,Norville Carey,JR,2014-15,F,Southern Mississippi,CUSA,27,730,113,207,108,190,5,17,60,91,58,94,152,22,24,24,52,62,291
988,Ty Charles,FR,2014-15,G,Stephen F. Austin,Southland,34,747,96,199,65,122,31,77,68,85,60,111,171,59,29,5,41,80,291
989,Anthony Henderson,SR,2014-15,G,Bowling Green State,MAC,33,861,105,217,60,106,45,111,36,56,38,63,101,42,30,8,23,50,291
990,Anthony Johnson,SR,2014-15,G,Northern Illinois,MAC,27,616,105,242,71,151,34,91,47,67,19,39,58,26,11,0,28,37,291
991,Brandon Taylor,JR,2014-15,F,Penn State,Big Ten,32,860,109,294,55,133,54,161,19,30,28,142,170,29,17,25,55,65,291
992,Michael Buchanan,SO,2014-15,C,South Carolina Upstate,A-Sun,36,682,119,215,118,214,1,1,51,88,93,117,210,23,18,33,50,82,290
993,Justin Burrell,SR,2014-15,G,Holy Cross,Patriot,30,820,93,251,60,148,33,103,71,86,8,46,54,123,38,0,53,45,290
994,Mario Dunn,SO,2014-15,G,Montana,Big Sky,33,1046,104,213,78,142,26,71,56,79,16,111,127,126,59,11,83,84,290
995,Vince Edwards,FR,2014-15,F,Purdue,Big Ten,33,889,110,228,81,139,29,89,41,52,64,95,159,90,12,13,50,73,290
996,Denell Henderson,SR,2014-15,F,Oral Roberts,Summit,33,687,108,206,105,194,3,12,71,102,70,96,166,25,6,43,66,102,290
997,Cleon Roberts,SO,2014-15,G,La Salle,A-10,33,941,90,253,43,112,47,141,63,83,23,74,97,35,39,12,41,100,290
998,Marcus Roper,JR,2014-15,G,Tennessee State,OVC,29,675,96,268,35,78,61,190,37,54,19,63,82,18,23,8,43,44,290
999,Rayshawn Simmons,JR,2014-15,G,Central Michigan,MAC,32,887,99,227,83,173,16,54,76,100,30,89,119,130,35,3,60,75,290
1000,Zach Stahl,SO,2014-15,G,Northeastern,CAA,35,969,119,209,119,209,0,0,52,79,66,139,205,69,22,12,79,87,290
1001,Ya Ya Anderson,JR,2014-15,G,Radford,Big South,31,872,102,238,43,71,59,167,26,40,13,45,58,55,24,0,21,39,289
1002,Kyle Castlin,FR,2014-15,G,Columbia,Ivy,28,747,101,220,77,156,24,64,63,78,53,65,118,27,22,8,35,48,289
1003,Farad Cobb,JR,2014-15,G,Cincinnati,AAC,34,821,99,259,46,100,53,159,38,48,18,67,85,49,33,4,37,36,289
1004,BaeBae Daniels,JR,2014-15,F,North Florida,A-Sun,31,763,103,206,81,150,22,56,61,87,66,117,183,32,13,55,32,81,289
1005,Chris Jones,SO,2014-15,G-F,Pittsburgh,ACC,34,933,109,253,68,138,41,115,30,55,37,68,105,68,15,11,34,83,289
1006,Wendell Lewis,SR,2014-15,C,Alabama State,SWAC,29,655,118,235,118,234,0,1,53,80,53,92,145,29,17,27,57,74,289
1007,Jamel Outler,SR,2014-15,G,Texas-Arlington,Sun Belt,31,733,89,249,33,71,56,178,55,88,8,34,42,28,25,0,45,63,289
1008,Kourtney Roberson,SR,2014-15,F,Texas A&amp;M,SEC,33,795,117,186,117,186,0,0,55,92,81,132,213,37,17,13,33,76,289
1009,Akeem Springs,SO,2014-15,G,Milwaukee,Horizon,28,868,100,246,76,162,24,84,65,92,36,100,136,48,17,3,53,43,289
1010,Jalil Abdul-Bassit,SR,2014-15,G,Oregon,Pac-12,35,699,99,227,40,91,59,136,31,38,19,42,61,25,21,12,35,80,288
1011,Aaron Brown,JR,2014-15,F,Saint Joseph's,A-10,31,758,96,226,88,198,8,28,88,126,34,86,120,37,19,5,50,65,288
1012,Bo Calhoun,JR,2014-15,F,Ball State,MAC,30,762,116,221,100,170,16,51,40,50,55,124,179,18,13,14,39,81,288
1013,Galal Cancer,SR,2014-15,G,Cornell,Ivy,30,896,91,232,67,169,24,63,82,101,37,66,103,91,29,8,61,86,288
1014,Angel Delgado,FR,2014-15,F,Seton Hall,Big East,31,873,121,218,121,217,0,1,46,111,112,193,305,27,16,39,39,78,288
1015,Ahmed Hill,FR,2014-15,G,Virginia Tech,ACC,33,978,99,248,67,165,32,83,58,84,35,87,122,51,15,4,51,74,288
1016,J.R. Holder,SO,2014-15,F,Jacksonville,A-Sun,32,900,96,238,79,181,17,57,79,114,38,97,135,40,21,8,65,62,288
1017,Cameron Jones,JR,2014-15,G,Radford,Big South,34,610,109,222,64,119,45,103,25,39,34,61,95,20,12,11,34,58,288
1018,Steve Moundou-Missi,SR,2014-15,F,Harvard,Ivy,30,898,115,251,111,241,4,10,54,75,57,162,219,28,26,43,47,75,288
1019,Javion Ogunyemi,SO,2014-15,F,Siena,MAAC,31,833,119,218,119,218,0,0,50,90,77,71,148,25,9,48,42,106,288
1020,Richard Ross,SR,2014-15,F,Old Dominion,CUSA,35,883,132,222,132,222,0,0,24,50,73,123,196,42,26,54,54,69,288
1021,Kevin Thomas,JR,2014-15,F,Troy,Sun Belt,28,911,122,198,122,196,0,2,44,71,99,128,227,31,38,31,82,65,288
1022,Dwayne Benjamin,JR,2014-15,F,Oregon,Pac-12,34,789,111,248,75,146,36,102,29,59,57,139,196,35,30,15,26,70,287
1023,Adonis Burbage,JR,2014-15,F,Gardner-Webb,Big South,35,958,104,250,40,76,64,174,15,24,26,62,88,38,26,3,49,77,287
1024,Kevin Ferguson,JR,2014-15,C,Army,Patriot,30,779,116,182,116,182,0,0,55,87,61,109,170,37,14,45,51,85,287
1025,Josh Fox,JR,2014-15,F,California-Davis,Big West,32,754,112,188,111,179,1,9,62,106,42,95,137,35,12,10,32,66,287
1026,Justin Gant,SR,2014-15,C,Indiana State,MVC,30,848,109,254,86,183,23,71,46,69,34,91,125,23,17,26,41,59,287
1027,Langston Morris-Walker,JR,2014-15,G,Oregon State,Pac-12,31,946,97,269,59,148,38,121,55,78,33,109,142,44,30,2,40,60,287
1028,Adam Weary,JR,2014-15,G,High Point,Big South,31,712,98,210,81,161,17,49,74,99,14,60,74,85,20,4,60,60,287
1029,Austin Hamilton,SR,2014-15,G,Elon,CAA,32,789,103,245,72,152,31,93,49,75,22,56,78,100,29,1,58,55,286
1030,Markus Kennedy,JR,2014-15,F,Southern Methodist,AAC,24,551,108,197,108,194,0,3,70,109,56,94,150,27,33,20,37,53,286
1031,Matt Miller,SR,2014-15,G,New Hampshire,AEC,29,662,100,212,37,81,63,131,23,31,13,74,87,34,11,1,21,44,286
1032,Marc Brown,SR,2014-15,G,Illinois-Chicago,Horizon,34,849,80,247,52,164,28,83,97,119,33,80,113,37,19,3,42,58,285
1033,Jevon Carter,FR,2014-15,G,West Virginia,Big 12,35,832,95,264,47,111,48,153,47,61,39,43,82,62,67,3,41,67,285
1034,Chris Cokley,FR,2014-15,F,Alabama-Birmingham,CUSA,36,620,119,220,119,219,0,1,47,71,73,95,168,18,24,24,35,59,285
1035,Tyron Criswell,JR,2014-15,G,Nevada,MWC,31,734,101,236,81,177,20,59,63,92,60,66,126,51,24,2,58,81,285
1036,Daniel Dion,SO,2014-15,G,New Hampshire,AEC,31,795,95,253,39,104,56,149,39,53,7,47,54,46,31,0,49,50,285
1037,Reco McCarter,SR,2014-15,G-F,Campbell,Big South,28,776,100,226,73,134,27,92,58,104,39,80,119,57,43,19,67,63,285
1038,Rashad Smith,JR,2014-15,F,Tulsa,AAC,34,962,115,253,105,214,10,39,45,86,57,146,203,25,17,16,42,67,285
1039,Steve Zack,JR,2014-15,C,La Salle,A-10,33,1029,115,258,114,252,1,6,54,79,89,214,303,61,24,58,61,91,285
1040,Anthlon Bell,JR,2014-15,G,Arkansas,SEC,36,660,95,257,30,72,65,185,29,41,12,30,42,50,21,4,32,62,284
1041,Laimonas Chatkevicius,JR,2014-15,F,South Carolina,SEC,33,753,118,237,110,210,8,27,40,55,52,120,172,21,11,44,45,74,284
1042,Milton Doyle,SO,2014-15,G,Loyola (IL),MVC,25,677,94,194,65,125,29,69,67,102,12,69,81,106,31,15,77,56,284
1043,Ed Dyson,SR,2014-15,F,Austin Peay,OVC,30,886,93,238,58,124,35,114,63,94,15,72,87,48,29,3,46,68,284
1044,Chris Freeman,SR,2014-15,F,Austin Peay,OVC,30,759,118,198,118,198,0,0,48,68,51,104,155,21,13,23,50,81,284
1045,Rod Hall,SR,2014-15,G,Clemson,ACC,31,1061,92,227,73,167,19,60,81,107,9,63,72,106,27,6,64,55,284
1046,Jovaughn Love,JR,2014-15,G-F,Arkansas-Pine Bluff,SWAC,26,703,100,263,81,199,19,64,65,98,42,87,129,25,16,28,48,59,284
1047,Deandre Mathieu,SR,2014-15,G,Minnesota,Big Ten,33,936,110,240,97,198,13,42,51,71,23,67,90,143,64,1,54,75,284
1048,Steven Thornton,SR,2014-15,F,California-Riverside,Big West,31,890,87,224,47,107,40,117,70,94,29,72,101,32,33,10,38,101,284
1049,Gabe Vincent,FR,2014-15,G,California-Santa Barbara,Big West,28,733,97,229,40,92,57,137,33,50,15,45,60,60,24,4,28,64,284
1050,Derek Cooke,SR,2014-15,F,Wyoming,MWC,35,921,116,161,115,160,1,1,50,92,51,153,204,33,30,31,49,78,283
1051,Wesley Myers,SO,2014-15,G,Niagara,MAAC,30,882,94,220,60,139,34,81,61,86,21,76,97,45,30,10,54,60,283
1052,Eric Robertson,SO,2014-15,G,Chattanooga,Southern,32,671,94,196,29,57,65,139,30,42,21,38,59,37,14,10,30,46,283
1053,Kenrich Williams,SO,2014-15,F,Texas Christian,Big 12,33,917,102,214,91,183,11,31,68,112,93,128,221,46,30,32,36,80,283
1054,Alex Young,JR,2014-15,G,California-Irvine,Big West,30,891,102,248,75,168,27,80,52,69,17,88,105,109,40,9,49,55,283
1055,Grant Benzinger,FR,2014-15,G,Wright State,Horizon,31,722,99,214,40,77,59,137,25,37,18,72,90,22,10,5,21,75,282
1056,Devon Bookert,JR,2014-15,G,Florida State,ACC,28,983,85,227,32,92,53,135,59,73,13,88,101,74,27,3,69,56,282
1057,Perrin Buford,JR,2014-15,G-F,Middle Tennessee,CUSA,35,623,103,206,94,187,9,19,67,95,55,69,124,20,13,22,45,61,282
1058,Trahson Burrell,JR,2014-15,F,Memphis,AAC,31,741,105,234,85,165,20,69,52,81,73,87,160,59,27,17,38,58,282
1059,Nathan Dieudonne,JR,2014-15,F,Boston University,Patriot,29,881,99,209,84,151,15,58,69,107,69,147,216,47,21,12,56,85,282
1060,Clide Geffrard,JR,2014-15,F,Stephen F. Austin,Southland,33,524,99,194,79,132,20,62,64,93,38,58,96,29,20,16,54,63,282
1061,Jalen Hayes,FR,2014-15,F,Oakland,Horizon,33,786,99,199,95,187,4,12,80,114,55,114,169,38,33,11,42,85,282
1062,Eric Jacobsen,JR,2014-15,F,Arizona State,Pac-12,34,972,102,163,102,163,0,0,78,137,84,118,202,32,19,41,61,122,282
1063,Phillip Leonard,JR,2014-15,G,Mercer,Southern,35,945,92,198,91,182,1,16,97,155,26,96,122,158,31,1,64,92,282
1064,Dulani Robinson,JR,2014-15,G,Pacific,WCC,31,777,87,257,38,114,49,143,59,73,19,67,86,79,26,2,47,57,282
1065,Tommy Spagnolo,SR,2014-15,F,Appalachian State,Sun Belt,29,780,115,227,109,210,6,17,46,63,60,143,203,29,15,13,61,81,282
1066,Fred Thomas,JR,2014-15,G,Mississippi State,SEC,31,757,84,223,37,86,47,137,67,85,16,95,111,25,23,15,47,58,282
1067,Anton Wilson,JR,2014-15,G,Detroit Mercy,Horizon,33,800,95,204,39,70,56,134,36,42,24,84,108,57,27,7,43,69,282
1068,Marqueze Coleman,JR,2014-15,G,Nevada,MWC,30,778,91,238,78,194,13,44,86,114,5,78,83,70,33,3,60,70,281
1069,Nnamdi Ezenwa,SR,2014-15,F,Idaho State,Big Sky,30,954,89,197,56,123,33,74,70,101,36,105,141,53,36,7,52,79,281
1070,Savon Goodman,SO,2014-15,F,Arizona State,Pac-12,25,654,115,199,115,199,0,0,51,91,66,123,189,19,20,9,51,71,281
1071,Isiah Jones,JR,2014-15,G,Southeast Missouri State,OVC,29,724,96,238,33,79,63,159,26,37,21,70,91,56,19,2,55,59,281
1072,Harold McBride,JR,2014-15,G,Gardner-Webb,Big South,35,830,91,228,49,108,42,120,57,78,15,63,78,79,40,2,49,68,281
1073,Brandon Peel,JR,2014-15,F,Central Connecticut State,NEC,31,1026,125,267,121,256,4,11,27,44,99,173,272,31,25,52,70,80,281
1074,Brandon Pye,JR,2014-15,G,Texas A&amp;M-Corpus Christi,Southland,31,951,98,231,51,113,47,118,38,46,5,37,42,21,25,0,30,39,281
1075,Jordon Talley,FR,2014-15,G,North Carolina-Wilmington,CAA,32,849,85,221,71,174,14,47,97,123,13,50,63,98,49,3,63,115,281
1076,Lance Crawford,FR,2014-15,G,Massachusetts-Lowell,AEC,29,830,83,205,56,126,27,79,87,113,16,67,83,66,18,1,58,64,280
1077,Khallid Hart,SO,2014-15,G,Marist,MAAC,19,627,85,219,51,110,34,109,76,89,7,44,51,31,17,2,37,50,280
1078,Lavon Long,SO,2014-15,G-F,Siena,MAAC,27,733,102,222,95,204,7,18,69,97,42,89,131,46,25,17,61,113,280
1079,Jordan Loveridge,JR,2014-15,F,Utah,Pac-12,28,735,89,214,35,90,54,124,48,55,12,97,109,28,17,6,38,48,280
1080,Keith Shamburger,SR,2014-15,G,Missouri,SEC,32,1092,80,211,37,80,43,131,77,86,17,89,106,124,37,4,60,68,280
1081,Joe Thomasson,JR,2014-15,G,Wright State,Horizon,28,872,94,191,76,132,18,59,74,95,30,123,153,90,24,25,53,84,280
1082,Kendal Williams,SR,2014-15,G,Delaware State,MEAC,33,814,96,256,57,146,39,110,49,63,24,61,85,93,14,1,48,63,280
1083,Jamaya Burr,SO,2014-15,G,McNeese State,Southland,31,929,85,231,78,193,7,38,102,143,21,46,67,126,36,0,73,34,279
1084,DK Eldridge,SR,2014-15,G,New Mexico State,WAC,34,880,102,262,65,136,37,126,38,60,26,64,90,74,37,2,63,61,279
1085,Austin Richie,SR,2014-15,G,Western Michigan,MAC,28,907,81,207,29,78,52,129,65,83,10,40,50,63,27,2,34,62,279
1086,Zarko Valjarevic,SR,2014-15,F,Maine,AEC,28,882,93,270,29,83,64,187,29,38,13,52,65,41,18,2,40,63,279
1087,Reece Chamberlain,SR,2014-15,G,Belmont,OVC,33,1031,90,207,68,142,22,65,76,119,57,121,178,198,55,5,84,70,278
1088,Kwan Cheatham,SO,2014-15,F,Akron,MAC,35,825,100,272,51,122,49,150,29,45,40,134,174,54,14,39,59,82,278
1089,Khalen Cumberlander,SO,2014-15,G,Central Connecticut State,NEC,28,899,103,254,65,137,38,117,34,53,16,63,79,62,23,2,64,51,278
1090,Michael Karena,JR,2014-15,C,Wright State,Horizon,31,699,121,224,121,224,0,0,36,71,49,64,113,16,15,10,60,113,278
1091,Max Landis,JR,2014-15,G,IPFW,Summit,30,911,84,182,44,70,40,112,70,81,6,60,66,72,22,0,30,52,278
1092,Jordyn Martin,JR,2014-15,F,Northern Arizona,Big Sky,36,1044,118,213,118,213,0,0,42,64,128,149,277,28,16,14,32,117,278
1093,Kurt Steidl,SO,2014-15,F,Vermont,AEC,34,928,86,216,29,64,57,152,49,61,20,103,123,39,24,13,40,65,278
1094,Dexter Werner,SO,2014-15,F,North Dakota State,Summit,33,656,107,209,107,209,0,0,64,95,69,108,177,24,19,34,39,75,278
1095,Ike Iroegbu,SO,2014-15,G,Washington State,Pac-12,31,836,90,207,64,134,26,73,71,95,10,78,88,106,17,4,60,67,277
1096,Denzel Johnson,SR,2014-15,G,Santa Clara,WCC,32,1017,102,263,68,172,34,91,39,51,20,71,91,59,37,3,38,62,277
1097,Shaun Lawton,JR,2014-15,G,Maine,AEC,29,917,89,219,66,139,23,80,76,100,14,111,125,81,54,2,76,79,277
1098,Jeremy Major,SO,2014-15,G,Pepperdine,WCC,32,929,93,245,59,141,34,104,57,90,20,88,108,115,50,7,67,88,277
1099,Greg Mortimer,SO,2014-15,G,South Carolina State,MEAC,31,783,92,221,78,172,14,49,79,108,30,46,76,48,15,4,62,39,277
1100,John Papale,JR,2014-15,G,Boston University,Patriot,30,1111,95,234,38,83,57,151,30,42,14,68,82,102,19,7,40,56,277
1101,Danny Robison,JR,2014-15,F,Montana State,Big Sky,30,794,93,205,59,114,34,91,57,89,41,97,138,20,8,8,38,97,277
1102,Kelvin Amayo,SO,2014-15,G,Iona,MAAC,35,860,105,211,101,190,4,21,62,123,62,113,175,96,35,14,73,100,276
1103,Volodymyr Gerun,SR,2014-15,F-C,Portland,WCC,33,802,106,213,103,200,3,13,61,91,89,108,197,27,22,39,55,87,276
1104,Shawn Olden,FR,2014-15,G,Pepperdine,WCC,30,855,81,217,46,101,35,116,79,107,23,50,73,55,30,8,54,62,276
1105,Solomon Poole,JR,2014-15,G,Florida Atlantic,CUSA,22,635,100,296,52,155,48,141,28,44,13,54,67,49,18,4,73,58,276
1106,Donovan Ross,SR,2014-15,F,Lamar,Southland,30,710,98,190,97,181,1,9,79,97,43,75,118,23,27,20,50,62,276
1107,Wayne Sparrow,SR,2014-15,G,Maryland-Baltimore County,AEC,20,646,95,263,63,170,32,93,54,84,21,72,93,44,32,15,66,63,276
1108,Tre'Shawn Thurman,FR,2014-15,F,Nebraska-Omaha,Summit,29,749,99,213,86,169,13,44,65,102,33,130,163,26,31,30,41,79,276
1109,Bobby Word,SO,2014-15,G,Oral Roberts,Summit,33,761,86,219,30,76,56,143,48,63,19,60,79,28,11,5,17,49,276
1110,Alante Fenner,SO,2014-15,G,Savannah State,MEAC,30,727,101,252,85,192,16,60,57,87,32,89,121,44,43,4,65,63,275
1111,Jameel McKay,JR,2014-15,F,Iowa State,Big 12,25,679,98,168,98,168,0,0,79,132,68,122,190,14,19,59,30,57,275
1112,Marquise Moore,SO,2014-15,G,George Mason,A-10,29,879,91,201,85,181,6,20,87,110,14,79,93,89,27,9,66,66,275
1113,Jaqawn Raymond,JR,2014-15,G,Middle Tennessee,CUSA,36,1088,83,226,41,104,42,122,67,81,12,99,111,75,36,8,74,74,275
1114,Bryce Scott,JR,2014-15,G,Lafayette,Patriot,33,954,93,220,42,91,51,129,38,49,21,87,108,79,32,0,36,58,275
1115,Romello Walker,FR,2014-15,G,Binghamton,AEC,32,986,100,281,78,197,22,84,53,94,38,109,147,31,30,7,63,64,275
1116,Jibri Bryan,JR,2014-15,G,Mercer,Southern,35,1040,89,244,45,90,44,154,52,67,29,128,157,44,49,7,45,91,274
1117,Donte Grantham,FR,2014-15,F,Clemson,ACC,31,918,102,274,61,127,41,147,29,53,50,92,142,52,27,31,53,46,274
1118,Aurimas Majauskas,SO,2014-15,F,Sam Houston State,Southland,34,469,85,152,74,126,11,26,93,120,55,83,138,17,8,3,41,78,274
1119,David Nwaba,JR,2014-15,G-F,Cal Poly,Big West,24,642,101,236,99,226,2,10,70,110,35,78,113,35,31,14,36,50,274
1120,Gabriel Olaseni,SR,2014-15,C,Iowa,Big Ten,34,634,92,177,92,177,0,0,90,120,74,90,164,15,10,54,38,92,274
1121,Curtis Phillips,FR,2014-15,F,Campbell,Big South,32,750,84,222,40,103,44,119,62,87,37,96,133,31,29,12,48,74,274
1122,Hakeem Baxter,FR,2014-15,G,Alabama-Birmingham,CUSA,36,940,81,215,66,150,15,65,96,121,14,95,109,55,29,10,56,72,273
1123,Lamonte Bearden,FR,2014-15,G,Buffalo,MAC,33,974,83,216,71,170,12,46,95,129,26,68,94,144,45,9,74,91,273
1124,Khadeen Carrington,FR,2014-15,G,Seton Hall,Big East,31,776,90,235,73,175,17,60,76,101,27,62,89,57,24,6,50,75,273
1125,Matt Costello,JR,2014-15,F,Michigan State,Big Ten,39,794,110,190,110,186,0,4,53,79,79,123,202,29,16,48,31,107,273
1126,Gregory Graves,JR,2014-15,F,Mount St. Mary's,NEC,27,797,90,213,71,163,19,50,74,107,65,134,199,34,34,14,46,65,273
1127,Corey Henson,FR,2014-15,G,Wagner,NEC,30,812,101,256,60,129,41,127,30,40,21,45,66,47,26,2,54,75,273
1128,Marcus Marshall,SO,2014-15,G,Missouri State,MVC,14,456,85,185,44,95,41,90,62,69,3,42,45,23,10,2,19,22,273
1129,Marc Eddy Norelia,SO,2014-15,F,Florida Gulf Coast,A-Sun,33,723,110,216,110,216,0,0,53,86,56,114,170,29,14,7,43,58,273
1130,Onochie Ochie,SR,2014-15,F,Southeastern Louisiana,Southland,32,736,101,173,99,168,2,5,69,109,49,122,171,12,15,31,57,124,273
1131,Colin Voss,SR,2014-15,F,North Texas,CUSA,31,926,105,218,105,217,0,1,63,78,54,126,180,58,15,24,47,88,273
1132,Brian Williams,SR,2014-15,F,Louisiana-Lafayette,Sun Belt,27,623,101,214,92,191,9,23,62,84,38,61,99,27,23,16,42,42,273
1133,Demarco Cox,SR,2014-15,C,Georgia Tech,ACC,31,826,116,229,116,229,0,0,40,81,76,112,188,19,14,28,44,69,272
1134,Avery Moore,SR,2014-15,G,Jacksonville State,OVC,30,800,88,253,23,54,65,199,31,37,10,54,64,52,22,3,28,51,272
1135,Daniel Mullings,SR,2014-15,G,New Mexico State,WAC,22,637,83,192,70,156,13,36,93,132,42,66,108,59,47,9,51,58,272
1136,Tramique Sutherland,JR,2014-15,G,Bradley,MVC,24,864,93,260,79,215,14,45,72,96,36,57,93,73,25,0,57,48,272
1137,Jake Zuilhof,SO,2014-15,F-C,Central Arkansas,Southland,29,877,100,194,100,194,0,0,72,111,68,110,178,31,23,49,74,83,272
1138,Devonte Elliott,SR,2014-15,F,Cal State Northridge,Big West,33,882,102,258,94,219,8,39,59,73,41,144,185,29,20,44,50,91,271
1139,Evan Hymes,SR,2014-15,G,Siena,MAAC,30,611,88,213,63,135,25,78,70,94,15,20,35,47,25,0,46,54,271
1140,Isaiah McCray,SR,2014-15,G,IPFW,Summit,31,894,90,218,50,108,40,110,51,105,22,151,173,72,40,31,49,88,271
1141,Cameron Ridley,JR,2014-15,C,Texas,Big 12,34,727,97,174,97,174,0,0,77,126,79,101,180,13,9,60,50,65,271
1142,Daviyon Draper,JR,2014-15,F,Florida International,CUSA,31,836,100,225,91,200,9,25,61,85,33,124,157,35,49,22,63,85,270
1143,Javan Felix,JR,2014-15,G,Texas,Big 12,31,723,96,231,45,101,51,130,27,36,13,54,67,61,11,3,49,36,270
1144,Patrick Heckmann,SR,2014-15,G,Boston College,ACC,32,938,93,198,68,111,25,87,59,75,37,103,140,87,40,12,61,90,270
1145,Isaiah Jackson,FR,2014-15,G,George Mason,A-10,31,811,81,233,50,146,31,87,77,109,32,88,120,41,25,1,63,63,270
1146,Julian Jacobs,SO,2014-15,G,Southern California,Pac-12,32,866,106,211,97,179,9,32,49,73,34,103,137,113,36,13,84,72,270
1147,Jamail Jones,SR,2014-15,G,Florida Gulf Coast,A-Sun,23,675,101,234,70,147,31,87,37,54,29,95,124,24,9,3,35,39,270
1148,Jamaal Samuel,JR,2014-15,F,Louisiana-Monroe,Sun Belt,38,735,111,263,82,158,29,105,19,33,32,110,142,18,13,39,36,71,270
1149,Mikel Trapp,SR,2014-15,G,Bethune-Cookman,MEAC,31,943,92,243,31,62,61,181,25,35,14,74,88,37,14,0,42,60,270
1150,Jeremiah Williams,SR,2014-15,G,Canisius,MAAC,33,718,89,226,46,109,43,117,49,59,13,52,65,59,34,5,53,54,270
1151,Keyshawn Woods,FR,2014-15,G,Charlotte,CUSA,32,813,103,211,62,123,41,88,23,34,14,61,75,39,17,3,39,58,270
1152,Jordan Allen,SR,2014-15,F,Sacred Heart,NEC,31,666,109,175,109,175,0,0,51,104,61,70,131,28,23,11,48,98,269
1153,Camyn Boone,JR,2014-15,F,Missouri State,MVC,31,710,101,177,101,177,0,0,67,99,63,105,168,23,12,25,43,101,269
1154,Kevin Brown,JR,2014-15,G,New Orleans,Southland,24,615,82,217,38,101,44,116,61,81,14,45,59,41,28,5,52,51,269
1155,Evan Conti,SR,2014-15,G,Quinnipiac,MAAC,30,810,86,236,38,97,48,139,49,63,40,105,145,77,13,3,56,60,269
1156,Joe De Ciman,JR,2014-15,G,Colorado State,MWC,34,943,85,213,40,95,45,118,54,63,16,97,113,56,16,20,33,90,269
1157,Phillip Lawrence,JR,2014-15,F,Marist,MAAC,32,846,95,207,62,110,33,97,46,70,33,88,121,29,19,12,38,79,269
1158,Caris LeVert,JR,2014-15,G,Michigan,Big Ten,18,645,93,221,61,142,32,79,51,63,5,83,88,67,32,7,39,31,269
1159,Sam McBeath,JR,2014-15,F,Nicholls State,Southland,29,728,92,201,69,130,23,71,62,98,55,140,195,49,23,15,69,78,269
1160,Reese Morgan,JR,2014-15,G,Cal Poly,Big West,27,583,66,181,27,57,39,124,98,114,30,55,85,31,19,3,27,66,269
1161,Ja'Mill Powell,JR,2014-15,G,Eastern Kentucky,OVC,33,730,84,218,43,97,41,121,60,82,21,43,64,37,24,9,48,75,269
1162,Phillip Anglade,JR,2014-15,F,Virginia Military Institute,Southern,30,693,111,185,111,184,0,1,46,97,91,82,173,25,24,87,43,101,268
1163,Gilvydas Biruta,SR,2014-15,F,Rhode Island,A-10,33,687,103,184,101,173,2,11,60,87,67,84,151,33,17,15,43,92,268
1164,Nate Buss,SR,2014-15,F,Northern Iowa,MVC,35,613,94,200,54,102,40,98,40,50,25,71,96,2,3,15,21,55,268
1165,John Gillon,SO,2014-15,G,Colorado State,MWC,34,708,61,168,27,82,34,86,112,141,5,51,56,110,12,2,41,49,268
1166,Connor Boehm,JR,2014-15,F,Dartmouth,Ivy,28,769,106,202,89,163,17,39,38,69,50,92,142,29,12,5,52,71,267
1167,C.J. Cooper,SR,2014-15,G,Texas-El Paso,CUSA,33,1018,82,214,34,78,48,136,55,74,5,54,59,106,21,1,43,45,267
1168,Jack Montague,JR,2014-15,G,Yale,Ivy,32,949,90,227,23,73,67,154,20,30,10,51,61,65,31,0,56,49,267
1169,Negus Webster-Chan,SO,2014-15,G,Hawaii,Big West,32,833,92,244,28,88,64,156,19,31,40,96,136,48,28,6,53,45,267
1170,Mo Alie-Cox,SO,2014-15,F,Virginia Commonwealth,A-10,36,935,101,170,101,170,0,0,64,106,110,95,205,28,23,68,38,77,266
1171,Kevin Blake,SR,2014-15,G,Elon,CAA,33,790,91,196,68,135,23,61,61,100,47,67,114,36,22,3,44,78,266
1172,Jaylen Bond,JR,2014-15,F,Temple,AAC,35,939,117,263,107,216,10,47,22,61,116,161,277,32,48,26,34,105,266
1173,Elvar Fridriksson,FR,2014-15,G,Long Island University,NEC,30,888,79,218,40,98,39,120,69,97,11,67,78,114,34,0,77,60,266
1174,Alandise Harris,SR,2014-15,F,Arkansas,SEC,35,748,96,202,87,170,9,32,65,90,38,77,115,53,28,35,41,74,266
1175,Jordan McLaughlin,FR,2014-15,G,Southern California,Pac-12,22,696,89,253,61,150,28,103,60,92,11,55,66,100,33,5,50,26,266
1176,Josiah Moore,JR,2014-15,G,Tennessee Tech,OVC,30,675,93,221,63,135,30,86,50,74,56,90,146,41,17,4,41,74,266
1177,Wes Washpun,JR,2014-15,G,Northern Iowa,MVC,35,767,86,177,71,139,15,38,79,116,8,79,87,91,34,17,65,62,266
1178,Jake Wiegand,JR,2014-15,F,Illinois-Chicago,Horizon,34,688,94,225,89,203,5,22,73,102,69,107,176,8,13,2,44,78,266
1179,Amir Bell,FR,2014-15,G,Princeton,Ivy,30,867,89,180,76,135,13,45,74,117,9,81,90,77,16,13,48,102,265
1180,Gary Clark,FR,2014-15,F,Cincinnati,AAC,34,945,110,210,110,205,0,5,45,72,94,152,246,57,35,45,38,54,265
1181,Chivarsky Corbett,FR,2014-15,G-F,Delaware,CAA,30,725,87,212,41,94,46,118,45,55,27,98,125,24,21,17,30,49,265
1182,Luke Fischer,FR,2014-15,C,Marquette,Big East,24,704,106,174,106,173,0,1,53,91,39,76,115,22,13,53,43,81,265
1183,Josh Gasser,SR,2014-15,G,Wisconsin,Big Ten,40,1320,77,174,28,48,49,126,62,75,29,110,139,70,30,8,21,90,265
1184,Charlie Jones,FR,2014-15,G-F,American,Patriot,33,1087,88,178,64,114,24,64,65,84,19,104,123,61,28,16,35,64,265
1185,William Lee,FR,2014-15,F,Alabama-Birmingham,CUSA,33,783,97,200,76,154,21,46,50,63,55,143,198,36,17,51,46,67,265
1186,William Powell,SO,2014-15,F,Seattle,WAC,34,974,96,187,96,186,0,1,73,118,87,132,219,69,17,12,75,92,265
1187,Ghiavonni Robinson,SO,2014-15,G,Arkansas-Pine Bluff,SWAC,32,814,94,245,39,90,55,155,22,36,14,64,78,32,31,5,45,59,265
1188,Jarryn Skeete,JR,2014-15,G,Buffalo,MAC,29,861,86,224,25,66,61,158,32,41,20,72,92,44,33,2,21,61,265
1189,Robert Turner,SR,2014-15,G,Texas Tech,Big 12,32,781,92,254,61,146,31,108,50,69,27,66,93,59,26,2,50,42,265
1190,Kevin Ware,JR,2014-15,G,Georgia State,Sun Belt,35,1000,99,226,85,178,14,48,53,75,21,87,108,85,58,12,48,67,265
1191,Isaiah Whitehead,FR,2014-15,G,Seton Hall,Big East,22,612,91,248,55,144,36,104,47,63,22,63,85,78,30,14,73,53,265
1192,Kameron Woods,SR,2014-15,F,Butler,Big East,34,1065,91,180,91,180,0,0,83,126,101,236,337,39,40,32,41,69,265
1193,Corban Collins,FR,2014-15,G,Morehead State,OVC,30,822,85,219,44,100,41,119,53,67,22,93,115,65,30,4,55,72,264
1194,D.J. Fenner,SO,2014-15,G,Nevada,MWC,30,756,90,260,77,199,13,61,71,90,22,58,80,33,33,10,52,60,264
1195,Tevin Hammond,JR,2014-15,G,Arkansas-Pine Bluff,SWAC,32,994,80,243,44,121,36,122,68,98,20,59,79,92,78,1,95,98,264
1196,Norman Hobbie,SO,2014-15,G,Brown,Ivy,31,826,78,199,5,20,73,179,35,39,3,41,44,14,11,0,28,63,264
1197,Alfonzo McKinnie,SR,2014-15,F,Green Bay,Horizon,33,713,105,232,84,168,21,64,33,65,65,111,176,6,16,16,46,112,264
1198,Arkadiy Mkrtychyan,FR,2014-15,F,Idaho,Big Sky,30,633,86,150,84,143,2,7,90,131,51,94,145,16,13,2,38,82,264
1199,Braxton Tucker,SO,2014-15,F,Portland State,Big Sky,23,634,109,218,108,213,1,5,45,62,53,69,122,17,11,11,30,58,264
1200,Jordan Wilson,SO,2014-15,G,Northern Colorado,Big Sky,30,777,89,212,42,95,47,117,39,46,13,43,56,69,29,0,26,50,264
1201,Marlon Beck,SO,2014-15,G,Binghamton,AEC,32,968,83,225,33,85,50,140,47,68,11,72,83,84,33,2,56,56,263
1202,Greg Brown,JR,2014-15,G,Saint Francis (PA),NEC,32,882,93,184,71,127,22,57,55,73,10,74,84,76,20,4,40,71,263
1203,Justin Gordon,SO,2014-15,F,Wofford,Southern,35,743,105,192,104,191,1,1,52,96,66,75,141,46,19,17,54,93,263
1204,Jonathan Holton,JR,2014-15,F,West Virginia,Big 12,35,754,100,221,87,157,13,64,50,76,105,101,206,41,41,29,51,118,263
1205,Garrett Jackson,SR,2014-15,F,Saint Mary's (CA),WCC,31,680,98,188,77,143,21,45,46,64,59,76,135,40,16,12,34,66,263
1206,Parker Kelly,SR,2014-15,G,Eastern Washington,Big Sky,34,1059,78,202,13,53,65,149,42,53,11,77,88,36,11,10,14,62,263
1207,Shawn Kemp,SR,2014-15,F,Washington,Pac-12,27,709,110,181,110,181,0,0,43,72,50,45,95,6,7,19,30,64,263
1208,Kevin Little,FR,2014-15,G,Maine,AEC,21,620,96,257,52,144,44,113,27,35,11,42,53,55,23,0,49,36,263
1209,Johnathan Motley,FR,2014-15,F,Baylor,Big 12,34,730,100,240,97,225,3,15,60,96,75,68,143,23,14,46,55,97,263
1210,Austin Ruder,SO,2014-15,G,Missouri State,MVC,31,967,85,257,29,86,56,171,37,43,4,62,66,40,22,1,32,44,263
1211,Jackson Trapp,JR,2014-15,G,Florida Atlantic,CUSA,26,879,88,188,41,76,47,112,40,48,7,76,83,24,25,11,36,49,263
1212,Daniel Alexander,SR,2014-15,F,Grand Canyon,WAC,29,694,95,214,64,105,31,109,41,46,28,113,141,34,19,24,39,67,262
1213,Jacob Enevold Jensen,SO,2014-15,C,Drake,MVC,31,852,96,169,96,169,0,0,70,102,56,123,179,12,13,29,76,62,262
1214,Zach Kocur,SO,2014-15,G,Air Force,MWC,30,689,90,179,33,59,57,120,25,40,17,51,68,62,13,2,35,68,262
1215,Matt MacDonald,SO,2014-15,G,Fairleigh Dickinson,NEC,29,856,82,195,41,75,41,120,56,67,37,80,117,31,27,2,32,83,261
1216,Deon Mitchell,SR,2014-15,G,Northern Iowa,MVC,35,722,86,209,57,143,29,66,60,85,8,62,70,86,35,2,61,29,261
1217,Blake Simmons,SO,2014-15,G-F,Evansville,MVC,36,1079,92,199,63,112,29,87,48,58,13,52,65,84,24,9,44,55,261
1218,Devin Watson,FR,2014-15,G,San Francisco,WCC,31,732,82,214,66,150,16,64,81,111,13,39,52,78,31,0,59,58,261
1219,Josh Adeyeye,JR,2014-15,G-F,Jacksonville,A-Sun,32,623,86,227,26,72,60,155,28,35,9,72,81,15,13,4,34,59,260
1220,Chris Burgess,JR,2014-15,G,Appalachian State,Sun Belt,29,864,89,229,42,108,47,121,35,45,16,55,71,84,12,0,47,53,260
1221,Josh Cunningham,FR,2014-15,F,Bradley,MVC,33,999,96,221,81,157,15,64,53,93,86,161,247,18,34,14,50,60,260
1222,Tevin Falzon,JR,2014-15,F,Sacred Heart,NEC,32,722,87,204,84,187,3,17,83,121,102,140,242,26,26,48,54,75,260
1223,Darryl Gaynor,FR,2014-15,G,San Jose State,MWC,29,705,88,280,56,167,32,113,52,67,14,27,41,58,19,2,82,63,260
1224,L.J. Peak,FR,2014-15,F,Georgetown,Big East,33,834,91,231,74,162,17,69,61,87,24,51,75,32,28,12,44,67,260
1225,Yuta Watanabe,FR,2014-15,F,George Washington,A-10,35,787,86,224,47,112,39,112,49,59,29,95,124,22,15,21,25,72,260
1226,Mike Anderson,SR,2014-15,G,Washington,Pac-12,31,992,84,186,46,95,38,91,53,77,58,133,191,78,27,16,65,75,259
1227,Chad Holley,SR,2014-15,G,Massachusetts-Lowell,AEC,29,963,75,210,32,86,43,124,66,88,7,67,74,72,21,1,45,68,259
1228,Lester Medford,JR,2014-15,G,Baylor,Big 12,34,1005,88,224,41,102,47,122,36,58,11,37,48,106,51,3,57,83,259
1229,Yolonzo Moore,SR,2014-15,G,Hartford,AEC,30,990,88,220,54,104,34,116,49,69,15,100,115,80,32,1,55,60,259
1230,Spencer Parker,JR,2014-15,F,Bowling Green State,MAC,33,822,88,216,72,156,16,60,67,92,37,85,122,30,21,4,43,77,259
1231,Isaac Haas,FR,2014-15,C,Purdue,Big Ten,34,496,91,170,91,170,0,0,76,139,53,86,139,9,4,25,54,73,258
1232,Jabarie Hinds,JR,2014-15,G,Massachusetts,A-10,32,691,98,239,68,150,30,89,32,47,4,35,39,70,32,1,59,56,258
1233,Jared Johnson,JR,2014-15,G,Stephen F. Austin,Southland,31,418,87,186,41,74,46,112,38,46,8,38,46,39,18,5,40,55,258
1234,Tyler Lamb,SR,2014-15,G,Long Beach State,Big West,31,716,87,248,54,148,33,100,51,59,26,91,117,36,24,4,51,59,258
1235,Juan Anderson,SR,2014-15,F,Marquette,Big East,31,883,97,198,81,152,16,46,47,85,68,110,178,54,35,12,64,77,257
1236,Devin Brooks,SR,2014-15,G,Creighton,Big East,33,758,83,237,66,167,17,70,74,101,46,118,164,101,32,3,76,46,257
1237,Kory Brown,JR,2014-15,G,North Dakota State,Summit,31,807,96,197,84,162,12,35,53,92,39,114,153,51,25,22,71,90,257
1238,Tre Burnette,JR,2014-15,G,South Dakota,Summit,33,670,110,260,91,193,19,67,18,41,65,131,196,26,44,17,46,93,257
1239,Karachi Edo,SO,2014-15,F,Fresno State,MWC,32,716,93,165,93,165,0,0,71,105,66,70,136,9,10,41,21,65,257
1240,Noah Robotham,FR,2014-15,G,Akron,MAC,26,796,86,222,46,111,40,111,45,60,13,56,69,87,33,1,59,38,257
1241,Sebastian Saiz,SO,2014-15,F,Mississippi,SEC,34,790,104,180,104,179,0,1,49,76,66,120,186,10,22,33,28,99,257
1242,Jake Wright,FR,2014-15,G-F,Citadel,Southern,29,746,84,211,12,40,72,171,17,22,4,41,45,16,5,0,17,36,257
1243,Terrel de Rouen,JR,2014-15,G,North Dakota,Big Sky,29,727,92,245,61,138,31,107,41,62,11,51,62,65,34,4,63,87,256
1244,Joshua Filmore,SO,2014-15,G,Southeastern Louisiana,Southland,21,722,91,220,41,81,50,139,24,37,7,50,57,46,17,0,36,38,256
1245,Daniel Fowler,FR,2014-15,G,Furman,Southern,33,980,94,204,72,136,22,68,46,74,29,104,133,83,38,11,79,73,256
1246,Steve Glowiak,SR,2014-15,G,Sacred Heart,NEC,32,807,85,238,22,47,63,191,23,33,12,87,99,40,26,2,23,43,256
1247,Jourdan Grant,FR,2014-15,G,Maryland-Baltimore County,AEC,30,1048,89,238,76,180,13,58,65,116,18,120,138,121,49,6,99,72,256
1248,Roland Nyama,FR,2014-15,G-F,Stony Brook,AEC,35,856,85,211,44,106,41,105,45,65,40,86,126,53,28,20,49,68,256
1249,Rashad Ray,JR,2014-15,G,Tulsa,AAC,34,913,71,212,31,100,40,112,74,92,9,87,96,98,34,1,40,59,256
1250,Raeford Worsham,JR,2014-15,G,Jackson State,SWAC,19,618,88,220,78,177,10,43,70,116,64,86,150,41,27,5,44,37,256
1251,Diante Baldwin,SO,2014-15,G,North Carolina-Greensboro,Southern,25,800,91,220,78,177,13,43,60,93,25,84,109,88,42,9,59,74,255
1252,Josh Cuthbertson,SO,2014-15,F,South Carolina Upstate,A-Sun,36,764,98,234,61,117,37,117,22,37,58,92,150,67,26,3,40,51,255
1253,Kyle Davis,SO,2014-15,G,Dayton,A-10,36,1050,78,171,61,94,17,77,82,116,4,96,100,88,53,17,48,94,255
1254,Daxter Miles,FR,2014-15,G,West Virginia,Big 12,35,718,93,228,52,113,41,115,28,53,40,40,80,34,38,2,25,89,255
1255,Brian Pegg,SO,2014-15,G,Stetson,A-Sun,26,662,97,191,97,191,0,0,61,98,50,91,141,20,19,3,36,49,255
1256,Reggie Smith,SR,2014-15,G,Eastern Illinois,OVC,31,705,79,203,49,110,30,93,67,87,7,81,88,39,20,3,51,55,255
1257,Ahmad Starks,SR,2014-15,G,Illinois,Big Ten,33,794,91,265,43,118,48,147,25,30,8,45,53,73,22,4,37,51,255
1258,Nura Zanna,FR,2014-15,F,Long Island University,NEC,30,699,91,192,91,190,0,2,73,135,67,121,188,13,16,15,67,111,255
1259,Stefan Jankovic,SO,2014-15,F,Hawaii,Big West,24,491,85,173,69,123,16,50,68,96,47,70,117,17,14,33,42,80,254
1260,Bryce Pressley,JR,2014-15,G,Portland,WCC,31,914,83,206,35,97,48,109,40,55,37,77,114,91,26,10,50,63,254
1261,Jacquez Rozier,SR,2014-15,F,Middle Tennessee,CUSA,36,903,90,179,88,173,2,6,72,120,89,90,179,26,26,23,55,89,254
1262,Brandon Stewart,SR,2014-15,G,Bethune-Cookman,MEAC,18,573,68,199,45,119,23,80,95,123,38,57,95,23,17,3,51,48,254
1263,Markus Terry,SO,2014-15,G,Presbyterian,Big South,31,822,91,211,65,140,26,71,46,63,12,59,71,42,16,2,38,44,254
1264,Eric Thompson,JR,2014-15,F,Pacific,WCC,31,738,89,170,89,170,0,0,76,125,72,102,174,26,13,26,44,114,254
1265,Avery Woodson,SO,2014-15,G,Memphis,AAC,32,872,85,227,24,65,61,162,23,28,8,68,76,36,32,8,34,95,254
1266,Jaylin Airington,SO,2014-15,G,Cal State Bakersfield,WAC,33,922,81,201,61,140,20,61,71,92,46,74,120,59,22,7,40,99,253
1267,Tevin Broyles,SO,2014-15,G,New Orleans,Southland,29,687,88,193,82,167,6,26,71,110,24,75,99,43,28,8,65,67,253
1268,Marlin Mason,SR,2014-15,F,Cleveland State,Horizon,30,784,96,194,69,121,27,73,34,51,50,96,146,25,21,32,51,84,253
1269,Nick Norton,FR,2014-15,G,Alabama-Birmingham,CUSA,35,946,69,178,10,27,59,151,56,66,8,65,73,132,48,1,62,50,253
1270,M.J. Rhett,SR,2014-15,F,Mississippi,SEC,34,754,110,192,110,191,0,1,33,44,57,100,157,17,7,18,38,78,253
1271,Darion Atkins,SR,2014-15,F,Virginia,ACC,33,789,113,221,113,220,0,1,26,50,73,124,197,23,27,36,37,67,252
1272,Joel Awich,JR,2014-15,F,Cal Poly,Big West,29,850,93,255,68,185,25,70,41,56,46,131,177,35,22,38,44,86,252
1273,Marcel Davis,JR,2014-15,G,Utah Valley,WAC,30,917,87,211,71,165,16,46,62,97,15,92,107,123,28,3,75,66,252
1274,Mike Gesell,JR,2014-15,G,Iowa,Big Ten,34,866,97,238,81,178,16,60,42,61,12,54,66,135,33,5,61,58,252
1275,Isaiah Hicks,SO,2014-15,F,North Carolina,ACC,38,563,99,182,99,181,0,1,54,87,56,57,113,11,9,15,34,95,252
1276,Karamo Jawara,SR,2014-15,F,North Carolina Central,MEAC,33,1109,89,201,66,137,23,64,51,72,33,179,212,76,35,24,55,91,252
1277,Malachi Alexander,SO,2014-15,F,Holy Cross,Patriot,30,760,79,182,58,135,21,47,72,98,48,103,151,30,24,16,45,91,251
1278,Javares Brent,SO,2014-15,G,Jackson State,SWAC,31,799,81,254,10,35,71,219,18,23,14,88,102,23,19,7,29,36,251
1279,Marcus Byrd,JR,2014-15,F,Denver,Summit,30,846,87,178,38,67,49,111,28,35,14,96,110,54,15,10,44,86,251
1280,Ayodeji Egbeyemi,SR,2014-15,G,Loyola Marymount,WCC,26,708,86,215,72,177,14,38,65,82,23,66,89,38,17,10,49,44,251
1281,Ky Howard,JR,2014-15,G,NJIT,Ind,23,730,80,159,69,126,11,33,80,108,34,98,132,90,11,3,68,59,251
1282,Travis Souza,SR,2014-15,G,California-Irvine,Big West,34,879,78,169,11,24,67,145,28,33,14,87,101,50,28,5,33,32,251
1283,Maurice Strong,SR,2014-15,F,Alabama State,SWAC,29,792,102,234,102,233,0,1,47,91,65,159,224,31,16,24,47,65,251
1284,Jerome Garrison,SR,2014-15,G,Grand Canyon,WAC,32,848,87,182,68,117,19,65,57,90,36,71,107,40,13,10,32,83,250
1285,Hector Harold,SR,2014-15,F,Vermont,AEC,31,694,91,221,59,124,32,97,36,55,15,105,120,34,19,21,52,80,250
1286,Justin Harris,SR,2014-15,F,Quinnipiac,MAAC,30,808,88,205,87,191,1,14,73,92,90,103,193,23,8,32,42,53,250
1287,Cheddi Mosley,FR,2014-15,G,Boston University,Patriot,29,694,90,209,37,76,53,133,17,26,5,39,44,30,24,3,32,37,250
1288,K.C. Ross-Miller,SR,2014-15,G,Auburn,SEC,35,879,72,199,51,129,21,70,85,111,11,64,75,83,54,1,81,87,250
1289,Zedric Sadler,SO,2014-15,G,Rider,MAAC,33,801,88,213,57,126,31,87,43,64,21,75,96,63,42,7,38,59,250
1290,Deshon Taylor,FR,2014-15,G,Missouri-Kansas City,WAC,33,765,80,196,39,92,41,104,49,61,18,49,67,44,29,2,40,64,250
1291,Jordan Threloff,SR,2014-15,C,Northern Illinois,MAC,30,741,77,146,77,146,0,0,96,138,86,134,220,11,11,21,44,63,250
1292,JT Yoho,JR,2014-15,F,Wright State,Horizon,16,531,89,209,65,136,24,73,48,60,19,84,103,33,12,4,37,32,250
1293,Ryan Badowski,FR,2014-15,G,Longwood,Big South,34,752,78,202,17,43,61,159,32,44,15,68,83,17,22,3,26,73,249
1294,Jordan Fouse,JR,2014-15,G-F,Green Bay,Horizon,33,1060,101,203,91,160,10,43,37,72,74,160,234,121,64,37,56,93,249
1295,Winston Grays,JR,2014-15,G,James Madison,CAA,32,884,89,214,53,110,36,104,35,52,31,77,108,58,37,7,47,41,249
1296,Warren Jones,JR,2014-15,G,Bradley,MVC,21,553,72,212,38,97,34,115,71,109,6,48,54,35,33,5,30,32,249
1297,Leland King,SO,2014-15,F,Brown,Ivy,17,433,97,206,79,146,18,60,37,49,25,107,132,27,11,12,46,23,249
1298,Ambrose Mosley,SO,2014-15,G,Old Dominion,CUSA,35,786,81,229,18,43,63,186,24,33,13,57,70,29,16,1,24,52,249
1299,Justin Alston,JR,2014-15,F,Boston University,Patriot,30,751,105,184,105,183,0,1,38,55,50,112,162,27,17,20,47,79,248
1300,Xavier Cooks,FR,2014-15,G-F,Winthrop,Big South,32,825,97,181,94,165,3,16,51,83,59,135,194,49,24,47,57,80,248
1301,Dakari Johnson,SO,2014-15,C,Kentucky,SEC,39,635,79,156,79,156,0,0,90,144,67,112,179,29,14,36,42,69,248
1302,Bishop Mency,FR,2014-15,G,Rice,CUSA,32,934,81,230,22,57,59,173,27,42,27,77,104,36,17,8,54,84,248
1303,Jarmal Reid,JR,2014-15,F,Oregon State,Pac-12,30,668,84,191,83,186,1,5,79,107,27,55,82,35,26,12,41,99,248
1304,Ricky Tarrant,JR,2014-15,G,Alabama,SEC,19,491,69,167,40,70,29,97,81,101,5,36,41,38,27,0,34,43,248
1305,Frank Williams,SR,2014-15,G,Missouri-Kansas City,WAC,33,884,91,242,42,99,49,143,17,24,10,75,85,44,23,11,28,27,248
1306,Chris Wilson,SR,2014-15,G,Saint Joseph's,A-10,31,1023,88,237,47,101,41,136,31,54,20,113,133,84,35,3,49,43,248
1307,Eli Carter,JR,2014-15,G,Florida,SEC,28,686,85,235,42,94,43,141,34,42,7,48,55,55,24,0,44,46,247
1308,Marquel Curtis,JR,2014-15,G,Tulsa,AAC,34,931,92,204,73,138,19,66,44,63,32,81,113,52,20,3,61,53,247
1309,Rashun Davis,JR,2014-15,G,Radford,Big South,32,739,86,218,74,157,12,61,63,86,10,61,71,112,37,0,77,55,247
1310,Taylor Dyson,JR,2014-15,G,Hartford,AEC,30,676,73,213,13,49,60,164,41,47,12,71,83,18,8,0,21,54,247
1311,Ahman Fells,SR,2014-15,F,Illinois-Chicago,Horizon,33,752,98,187,69,113,29,74,22,32,43,82,125,16,30,9,21,70,247
1312,Chrishawn Hopkins,SR,2014-15,G,Wright State,Horizon,29,817,82,198,63,143,19,55,64,88,12,74,86,81,18,3,60,42,247
1313,Jalen Jenkins,SO,2014-15,F,George Mason,A-10,31,692,92,198,91,195,1,3,62,108,54,83,137,38,18,26,61,104,247
1314,Moses Morgan,SR,2014-15,F,Cal State Fullerton,Big West,31,794,89,270,45,128,44,142,25,45,16,54,70,18,14,8,42,54,247
1315,Davon Reed,SO,2014-15,G,Miami (FL),ACC,30,824,77,164,40,83,37,81,56,77,25,96,121,57,27,13,32,68,247
1316,Lamont Robinson,FR,2014-15,G,Mount St. Mary's,NEC,30,734,80,221,48,125,32,96,55,73,9,33,42,98,27,3,60,63,247
1317,Justin Seymour,SO,2014-15,G,Murray State,OVC,35,709,79,192,32,84,47,108,42,64,15,62,77,41,22,9,42,75,247
1318,DavRon Williams,SR,2014-15,F,IUPUI,Summit,31,721,101,175,101,174,0,1,45,77,64,132,196,22,22,22,44,96,247
1319,Matthew Fisher-Davis,FR,2014-15,G-F,Vanderbilt,SEC,34,777,80,228,9,51,71,177,15,21,16,63,79,46,13,16,31,55,246
1320,Kavin Gilder-Tilbury,SO,2014-15,F,Texas State,Sun Belt,31,714,76,206,50,134,26,72,68,90,37,72,109,38,34,6,53,75,246
1321,Montaque Gill-Caesar,FR,2014-15,G,Missouri,SEC,27,647,84,231,55,137,29,94,49,66,20,60,80,14,19,2,52,55,246
1322,Damarcus Harrison,SR,2014-15,G,Clemson,ACC,31,753,83,222,43,107,40,115,40,58,13,78,91,38,19,6,47,65,246
1323,Mike Kirkland,JR,2014-15,F,Fairfield,MAAC,31,784,87,215,78,180,9,35,63,84,36,87,123,32,17,4,50,80,246
1324,Trevor Lyons,FR,2014-15,G,Air Force,MWC,31,864,84,186,59,129,25,57,53,77,12,65,77,68,41,0,30,57,246
1325,Cameron Naylor,JR,2014-15,F,Texas State,Sun Belt,30,722,98,230,98,224,0,6,50,67,45,103,148,14,10,9,46,51,246
1326,David Taylor,SO,2014-15,F,Pacific,WCC,31,769,85,224,38,93,47,131,29,36,13,40,53,47,13,1,43,62,246
1327,Cedrick Bowen,SR,2014-15,F,Charleston Southern,Big South,31,735,103,166,103,166,0,0,39,60,76,56,132,19,19,14,24,53,245
1328,Eric Garcia,SO,2014-15,G,Wofford,Southern,32,860,68,158,36,69,32,89,77,102,7,56,63,80,20,1,41,43,245
1329,Stephan Holm,SO,2014-15,G,Montana State,Big Sky,25,600,82,212,32,66,50,146,31,35,8,46,54,11,7,1,36,30,245
1330,Reggie McAdams,JR,2014-15,F,Akron,MAC,35,648,81,189,16,31,65,158,18,23,22,49,71,22,20,14,8,39,245
1331,Corbin Miller,SO,2014-15,G,Harvard,Ivy,30,756,79,214,16,36,63,178,24,30,6,41,47,19,15,1,16,26,245
1332,Joe Reed,JR,2014-15,F,IPFW,Summit,30,771,89,164,79,136,10,28,57,85,43,92,135,43,20,11,37,60,245
1333,Aaron Wheeler,JR,2014-15,G,Charleston Southern,Big South,31,961,103,214,103,202,0,12,39,75,77,83,160,74,34,18,51,63,245
1334,Chris Bilbo,JR,2014-15,G,Troy,Sun Belt,29,1006,83,221,62,141,21,80,57,89,15,89,104,85,28,7,62,60,244
1335,Ollie Jackson,SR,2014-15,G,Saint Francis (PA),NEC,32,780,84,200,33,69,51,131,25,39,14,74,88,40,27,12,44,63,244
1336,Sean O'Brien,SO,2014-15,G,Southern Illinois,MVC,33,908,91,206,80,171,11,35,51,77,38,124,162,54,31,23,63,80,244
1337,James Reid,JR,2014-15,G,Arkansas-Little Rock,Sun Belt,31,725,76,194,24,44,52,150,40,52,7,67,74,43,16,1,23,66,244
1338,ShunQuez Stephens,JR,2014-15,F,South Carolina Upstate,A-Sun,35,772,90,213,68,133,22,80,42,57,62,153,215,45,27,8,43,88,244
1339,Thomas Wilder,FR,2014-15,G,Western Michigan,MAC,34,693,81,180,68,136,13,44,69,93,3,81,84,56,34,2,57,53,244
1340,Curtis Diamond,SR,2014-15,G,Georgia Southern,Sun Belt,31,769,83,239,47,101,36,138,41,74,21,75,96,31,19,5,39,62,243
1341,Kelan Martin,FR,2014-15,F,Butler,Big East,34,495,91,221,72,144,19,77,42,60,21,49,70,15,5,8,33,54,243
1342,Barrington Stevens,JR,2014-15,G,South Alabama,Sun Belt,33,1109,89,241,47,121,42,120,23,32,16,77,93,104,17,2,52,70,243
1343,John Walton,JR,2014-15,F,Troy,Sun Belt,29,810,87,204,87,203,0,1,69,115,60,105,165,21,16,5,59,89,243
1344,Tonnie Collier,JR,2014-15,F,Texas Southern,SWAC,33,521,73,175,36,66,37,109,59,76,28,64,92,9,8,2,33,45,242
1345,Chad Jackson,SR,2014-15,G,Northern Kentucky,A-Sun,30,783,88,179,88,176,0,3,66,110,63,101,164,63,26,4,44,78,242
1346,Olaf Schaftenaar,JR,2014-15,F,Oregon State,Pac-12,31,929,81,204,34,79,47,125,33,41,24,77,101,49,15,10,42,59,242
1347,Amin Torres,JR,2014-15,G,Nicholls State,Southland,24,459,77,189,39,86,38,103,50,62,4,28,32,34,29,3,49,49,242
1348,Quadir Welton,FR,2014-15,C-F,Saint Peter's,MAAC,34,807,95,200,95,200,0,0,52,110,91,93,184,21,19,27,58,110,242
1349,Cameron Wright,SR,2014-15,G,Pittsburgh,ACC,26,721,102,221,98,202,4,19,34,67,11,66,77,75,36,12,43,60,242
1350,Travon Baker,JR,2014-15,G,Northern Illinois,MAC,30,768,73,221,37,98,36,123,59,85,8,44,52,94,45,1,59,68,241
1351,Jabari Bird,SO,2014-15,G,California,Pac-12,23,648,92,210,61,126,31,84,26,34,22,54,76,40,11,10,28,51,241
1352,Demarcus Holland,JR,2014-15,G,Texas,Big 12,34,976,85,173,59,117,26,56,45,65,46,63,109,82,13,5,65,58,241
1353,Ben Moore,SO,2014-15,F,Southern Methodist,AAC,34,762,82,187,82,187,0,0,77,113,66,95,161,64,31,30,55,84,241
1354,Will Rassman,JR,2014-15,F,Loyola (MD),Patriot,30,736,90,198,80,181,10,17,51,72,39,96,135,29,14,24,40,102,241
1355,Donivine Stewart,JR,2014-15,G,Southern Illinois-Edwardsville,OVC,28,899,82,218,54,129,28,89,49,86,27,94,121,114,38,1,47,33,241
1356,Cedrick Williams,SR,2014-15,F,North Carolina-Wilmington,CAA,32,865,96,199,93,184,3,15,46,80,87,113,200,22,31,41,36,104,241
1357,Rosco Allen,JR,2014-15,F,Stanford,Pac-12,33,872,82,215,44,110,38,105,38,55,34,110,144,39,18,12,37,77,240
1358,Mislav Brzoja,SO,2014-15,G,Evansville,MVC,32,789,83,200,61,125,22,75,52,69,36,107,143,84,28,8,71,68,240
1359,Darnell Harris,JR,2014-15,F,Middle Tennessee,CUSA,36,641,86,196,54,110,32,86,36,47,39,80,119,22,10,10,30,66,240
1360,Rick Kreklow,SR,2014-15,G,Creighton,Big East,32,783,76,177,33,64,43,113,45,63,34,66,100,48,24,6,44,77,240
1361,Xavian Stapleton,FR,2014-15,G,Louisiana Tech,CUSA,36,558,85,206,52,91,33,115,37,53,29,45,74,12,26,23,24,67,240
1362,Mike Thomas,SO,2014-15,F,Hawaii,Big West,34,608,91,185,88,174,3,11,55,76,56,62,118,15,23,34,30,104,240
1363,Maurice Aniefiok,JR,2014-15,G-F,North Texas,CUSA,28,839,84,205,37,84,47,121,24,38,9,88,97,40,26,1,47,65,239
1364,Charles Bennett,JR,2014-15,G,Indiana State,MVC,30,688,74,190,33,72,41,118,50,64,12,62,74,90,24,1,56,54,239
1365,Amile Jefferson,JR,2014-15,F,Duke,ACC,39,831,94,149,94,149,0,0,51,92,91,135,226,33,22,26,41,76,239
1366,Peter Jok,SO,2014-15,G,Iowa,Big Ten,34,676,83,232,47,127,36,105,37,41,25,63,88,44,19,4,43,63,239
1367,Terry Larrier,FR,2014-15,G-F,Virginia Commonwealth,A-10,36,666,73,213,41,91,32,122,61,86,33,75,108,21,17,5,38,49,239
1368,I.J. Ready,SO,2014-15,G,Mississippi State,SEC,29,744,87,218,59,123,28,95,37,42,6,51,57,71,37,0,41,46,239
1369,Adjehi Baru,SR,2014-15,F,College of Charleston,CAA,32,834,91,191,91,191,0,0,56,104,71,130,201,25,18,18,48,101,238
1370,Ethan Montalvo,JR,2014-15,G,Texas State,Sun Belt,31,664,73,209,22,47,51,162,41,51,3,38,41,42,18,4,37,46,238
1371,Darien Nelson-Henry,JR,2014-15,C,Pennsylvania,Ivy,28,671,93,180,93,180,0,0,52,84,52,91,143,25,10,21,60,73,238
1372,Darreon Reddick,FR,2014-15,G,Tennessee State,OVC,31,842,82,205,60,156,22,49,52,75,19,93,112,42,22,2,61,83,238
1373,D'Andre Wright,JR,2014-15,F,Tulsa,AAC,34,730,81,208,68,162,13,46,63,89,68,82,150,30,7,12,51,115,238
1374,Mitchell Badillo,JR,2014-15,G,Incarnate Word,Southland,27,847,76,156,56,99,20,57,65,83,23,58,81,135,29,1,59,58,237
1375,Ben Dillard,JR,2014-15,G,Arkansas-Little Rock,Sun Belt,31,782,70,200,36,76,34,124,63,77,15,35,50,46,15,2,28,56,237
1376,Omari Grier,JR,2014-15,G,Bradley,MVC,30,682,74,196,40,89,34,107,55,70,12,41,53,27,11,1,37,37,237
1377,Josh Kozinski,FR,2014-15,G,Central Michigan,MAC,32,563,76,202,2,4,74,198,11,15,9,32,41,9,13,0,5,39,237
1378,Giddy Potts,FR,2014-15,G,Middle Tennessee,CUSA,36,649,80,213,34,91,46,122,31,41,10,88,98,31,26,4,40,64,237
1379,Mikey Thompson,JR,2014-15,G,Boise State,MWC,31,754,66,182,52,137,14,45,91,117,14,58,72,55,16,0,47,40,237
1380,LeRon Barnes,JR,2014-15,G,Houston,AAC,32,1083,82,199,55,116,27,83,45,63,68,138,206,43,26,22,40,86,236
1381,Kasey Hill,SO,2014-15,G,Florida,SEC,33,1000,89,235,81,206,8,29,50,95,13,64,77,149,32,8,72,66,236
1382,Mike Hughes,FR,2014-15,G,Georgia Southern,Sun Belt,31,940,80,185,50,89,30,96,46,68,49,102,151,70,40,7,43,60,236
1383,Reginald Johnson,FR,2014-15,F,Alcorn State,SWAC,24,497,96,212,82,166,14,46,30,45,56,30,86,11,4,2,16,40,236
1384,John Kopriva,SR,2014-15,F,George Washington,A-10,35,856,88,181,69,138,19,43,41,63,39,89,128,15,9,29,31,69,236
1385,Dominique McKoy,SR,2014-15,F,Duquesne,A-10,30,713,106,195,106,194,0,1,24,65,50,137,187,30,17,16,34,62,236
1386,Landry Nnoko,JR,2014-15,C,Clemson,ACC,31,753,95,187,95,187,0,0,46,70,71,96,167,21,6,63,47,100,236
1387,Angel Rivera,FR,2014-15,G,Stetson,A-Sun,31,751,72,158,37,70,35,88,57,84,12,61,73,120,17,1,50,60,236
1388,J.C. Show,FR,2014-15,G,Bucknell,Patriot,34,621,79,200,31,69,48,131,30,42,13,41,54,27,8,1,29,42,236
1389,Zavier Turner,SO,2014-15,G,Ball State,MAC,27,802,70,195,34,82,36,113,60,85,6,46,52,88,20,1,87,62,236
1390,Ryan Andino,FR,2014-15,G,Maryland-Eastern Shore,MEAC,33,709,75,182,11,30,64,152,21,27,9,25,34,24,16,0,18,38,235
1391,Staphon Blair,JR,2014-15,F,Central Florida,AAC,30,746,95,156,95,155,0,1,45,81,61,94,155,3,9,38,32,73,235
1392,Bobby Brown,JR,2014-15,G-F,Alabama State,SWAC,28,639,81,215,45,120,36,95,37,50,38,107,145,32,8,21,40,37,235
1393,Bishop Daniels,JR,2014-15,G,Rutgers,Big Ten,28,694,82,212,67,159,15,53,56,78,10,50,60,47,18,14,71,60,235
1394,Toddrick Gotcher,JR,2014-15,G,Texas Tech,Big 12,32,775,72,191,30,79,42,112,49,72,27,58,85,48,25,13,31,58,235
1395,Matt Howard,SO,2014-15,G,Pennsylvania,Ivy,28,736,84,179,67,126,17,53,50,72,23,66,89,26,28,7,37,53,235
1396,Eric Stuteville,SO,2014-15,C,Sacramento State,Big Sky,33,679,96,183,96,181,0,2,43,75,49,69,118,7,8,34,33,82,235
1397,Ryan Taylor,FR,2014-15,G,Ohio,MAC,29,874,88,203,60,106,28,97,31,41,15,57,72,37,12,10,33,60,235
1398,Karon Wright,SO,2014-15,G,South Carolina State,MEAC,33,571,77,257,17,66,60,191,21,28,15,20,35,10,11,0,37,67,235
1399,Mike Crawford,SO,2014-15,G,Saint Louis,A-10,32,609,77,166,52,100,25,66,55,69,15,37,52,33,10,1,31,48,234
1400,Ronnie Drinnon,JR,2014-15,F,Saint Francis (PA),NEC,29,856,94,225,89,205,5,20,41,69,85,140,225,38,42,13,37,80,234
1401,Vashil Fernandez,SR,2014-15,C,Valparaiso,Horizon,34,841,93,165,93,165,0,0,48,94,78,123,201,11,15,97,32,94,234
1402,Charles Hankerson,SR,2014-15,G,Wyoming,MWC,34,974,83,215,41,93,42,122,26,57,12,96,108,89,31,0,47,69,234
1403,Byron Hawkins,FR,2014-15,G,Towson,CAA,32,613,74,219,47,126,27,93,59,79,12,48,60,49,11,3,44,64,234
1404,Matt Jones,SO,2014-15,G,Duke,ACC,39,847,84,205,43,96,41,109,25,35,34,57,91,39,37,3,29,66,234
1405,Billy Reader,SR,2014-15,C,Morehead State,OVC,31,719,100,209,100,209,0,0,34,59,73,77,150,31,14,28,36,76,234
1406,Jamal Reynolds,JR,2014-15,G,Canisius,MAAC,33,829,75,150,74,147,1,3,83,112,71,148,219,54,26,12,32,63,234
1407,Kareem Storey,SR,2014-15,G,Morehead State,OVC,31,931,75,192,50,123,25,69,59,70,17,49,66,140,42,2,76,71,234
1408,Rodell Wigginton,JR,2014-15,G-F,Buffalo,MAC,32,715,89,208,77,159,12,49,44,76,47,90,137,30,26,17,33,58,234
1409,Damien Wilson,JR,2014-15,F,Kennesaw State,A-Sun,22,632,88,230,83,189,5,41,53,68,31,75,106,42,18,7,59,50,234
1410,Antonio Woods,FR,2014-15,G,Pennsylvania,Ivy,28,890,83,221,60,138,23,83,45,66,12,53,65,106,19,2,59,55,234
1411,Spike Albrecht,JR,2014-15,G,Michigan,Big Ten,31,991,78,193,43,97,35,96,42,46,4,68,72,121,27,1,41,49,233
1412,Willie Clayton,JR,2014-15,F,Charlotte,CUSA,32,725,96,169,96,169,0,0,41,108,99,101,200,16,20,9,66,94,233
1413,Kendrec Ferrara,JR,2014-15,F,Furman,Southern,33,814,94,221,79,174,15,47,30,58,46,98,144,26,9,41,54,70,233
1414,Hayden Graham,SO,2014-15,F,Air Force,MWC,30,714,96,205,85,141,11,64,30,45,42,88,130,38,16,7,40,64,233
1415,Kyre' Hamer,SO,2014-15,G,Campbell,Big South,28,841,82,159,61,109,21,50,48,65,23,87,110,63,45,11,71,65,233
1416,Joel Hernandez,SO,2014-15,G,Long Island University,NEC,29,688,84,215,74,181,10,34,55,106,36,81,117,23,22,11,47,63,233
1417,Cornelius Hudson,FR,2014-15,F,Wake Forest,ACC,31,680,73,204,27,60,46,144,41,57,21,75,96,33,27,7,40,58,233
1418,Marvin King-Davis,JR,2014-15,F,Delaware,CAA,24,563,84,163,84,163,0,0,65,94,33,104,137,17,7,14,25,52,233
1419,Tyler Les,SR,2014-15,G,California-Davis,Big West,32,771,69,151,4,12,65,139,30,32,6,46,52,48,10,0,29,47,233
1420,Ryan Majerle,JR,2014-15,G,Grand Canyon,WAC,32,772,78,176,32,55,46,121,31,38,37,63,100,21,8,4,19,55,233
1421,Willie Moore,JR,2014-15,G,Miami (OH),MAC,32,665,75,179,42,91,33,88,50,69,10,78,88,34,47,3,58,84,233
1422,Mike Tobey,JR,2014-15,F-C,Virginia,ACC,34,582,93,181,93,180,0,1,47,63,66,106,172,12,9,22,26,66,233
1423,Chris Washburn,SO,2014-15,F,Texas Christian,Big 12,33,790,91,189,90,186,1,3,50,95,58,132,190,43,46,45,34,90,233
1424,Christopher Anderson,SR,2014-15,G,San Diego,WCC,30,973,78,210,48,116,30,94,46,76,14,73,87,197,58,2,85,75,232
1425,Dimitri Batten,SR,2014-15,G,Boston College,ACC,32,819,80,175,51,98,29,77,43,69,12,77,89,39,34,6,42,91,232
1426,Josh Brown,SO,2014-15,G,Temple,AAC,37,809,74,186,53,130,21,56,63,73,19,94,113,57,29,10,35,60,232
1427,Wes Clark,SO,2014-15,G,Missouri,SEC,23,713,81,233,49,131,32,102,38,51,10,71,81,71,38,4,45,54,232
1428,Demetrious Floyd,FR,2014-15,G,Stephen F. Austin,Southland,34,497,86,191,35,68,51,123,9,18,3,32,35,46,7,0,31,32,232
1429,Greg Gainey,SR,2014-15,F,Texas-Arlington,Sun Belt,24,493,87,194,58,110,29,84,29,41,31,65,96,9,9,11,23,62,232
1430,Tyrel Hunt,JR,2014-15,F,Alcorn State,SWAC,30,628,86,183,83,177,3,6,57,87,29,65,94,12,14,15,27,66,232
1431,Abdul Lewis,FR,2014-15,F,South Alabama,Sun Belt,33,910,88,188,87,184,1,4,55,104,63,164,227,22,9,18,72,91,232
1432,Trayvon Palmer,SO,2014-15,G-F,Chicago State,WAC,30,736,87,187,64,131,23,56,35,52,54,90,144,21,25,18,55,84,232
1433,Kenneth Smith,SR,2014-15,G,Louisiana Tech,CUSA,36,1190,75,198,40,102,35,96,47,61,28,115,143,267,69,4,89,84,232
1434,Kyndahl Hill,SO,2014-15,F,Weber State,Big Sky,30,802,72,156,55,105,17,51,70,91,38,114,152,25,18,24,47,91,231
1435,Robert Hubbs,SO,2014-15,G,Tennessee,SEC,32,795,88,215,57,122,31,93,24,33,36,57,93,28,16,4,26,48,231
1436,Branford Jones,SO,2014-15,G,Long Beach State,Big West,33,807,73,181,46,105,27,76,58,72,25,72,97,61,34,1,53,53,231
1437,Paris Lee,SO,2014-15,G,Illinois State,MVC,34,1013,80,184,54,113,26,71,45,62,12,69,81,124,82,2,65,62,231
1438,Shane McLaughlin,JR,2014-15,G,Bryant,NEC,31,1138,83,207,66,155,17,52,48,74,15,103,118,148,29,1,83,62,231
1439,Tosin Mehinti,SO,2014-15,F,Alabama-Birmingham,CUSA,34,763,95,186,95,186,0,0,41,72,54,106,160,25,12,68,61,87,231
1440,Tyler Roberson,SO,2014-15,F,Syracuse,ACC,28,803,93,210,93,207,0,3,45,70,79,124,203,45,25,18,33,57,231
1441,Bryce Washington,FR,2014-15,F,Louisiana-Lafayette,Sun Belt,36,845,94,176,90,164,4,12,39,58,67,121,188,56,23,18,46,73,231
1442,Kyle Washington,SO,2014-15,F,North Carolina State,ACC,34,604,98,210,91,197,7,13,28,39,40,99,139,15,7,37,32,71,231
1443,Carlin Dupree,SO,2014-15,G,North Dakota State,Summit,33,1077,89,241,80,199,9,42,43,77,29,121,150,86,40,2,58,60,230
1444,Junior Etou,SO,2014-15,F,Rutgers,Big Ten,31,919,81,207,58,133,23,74,45,68,46,160,206,18,12,13,38,57,230
1445,Shannon Hale,SO,2014-15,F,Alabama,SEC,28,542,75,180,49,94,26,86,54,77,29,60,89,32,21,14,53,54,230
1446,Matt Harris,FR,2014-15,G,Massachusetts-Lowell,AEC,26,534,77,185,30,58,47,127,29,38,10,37,47,20,17,2,24,40,230
1447,Mathieu Kamba,FR,2014-15,G,Central Arkansas,Southland,29,776,76,160,75,150,1,10,77,131,44,85,129,46,19,15,69,79,230
1448,Moussa Kone,SR,2014-15,F-C,Hofstra,CAA,26,525,97,144,97,144,0,0,36,60,57,89,146,13,13,21,22,83,230
1449,J.J. Panoske,JR,2014-15,F,Milwaukee,Horizon,30,624,86,190,64,126,22,64,36,42,30,80,110,25,10,31,43,64,230
1450,Abdul-Malik Abu,FR,2014-15,F,North Carolina State,ACC,36,687,87,186,86,181,1,5,54,96,68,104,172,22,6,18,35,79,229
1451,Marcus Allen,SO,2014-15,G,Stanford,Pac-12,36,820,89,174,76,134,13,40,38,71,41,84,125,41,30,4,41,88,229
1452,Phil Cofer,FR,2014-15,F,Florida State,ACC,33,737,78,171,72,156,6,15,67,106,51,98,149,6,9,20,34,57,229
1453,Troy Holston,FR,2014-15,G,South Florida,AAC,29,671,73,219,34,93,39,126,44,62,19,56,75,19,18,7,30,57,229
1454,Tyler Madison,SO,2014-15,G,Alabama-Birmingham,CUSA,36,618,77,170,71,153,6,17,69,91,70,53,123,37,12,6,34,87,229
1455,Stevie Taylor,SR,2014-15,G,Ohio,MAC,30,759,74,225,52,128,22,97,59,81,9,68,77,80,36,2,51,52,229
1456,Bo Barnes,SR,2014-15,G,Arizona State,Pac-12,33,634,76,178,30,55,46,123,30,35,33,42,75,25,22,5,19,47,228
1457,Anthony Collins,JR,2014-15,G,South Florida,AAC,32,1084,91,206,83,177,8,29,38,56,10,73,83,167,49,3,76,74,228
1458,Jack Crook,JR,2014-15,C,Seattle,WAC,34,847,90,176,90,176,0,0,48,73,57,132,189,55,14,7,63,116,228
1459,Dominique Elliott,JR,2014-15,F,Maryland-Eastern Shore,MEAC,32,673,81,179,80,165,1,14,65,100,53,90,143,39,29,6,70,95,228
1460,Dallas Gary,SR,2014-15,F,Coppin State,MEAC,29,548,70,188,56,127,14,61,74,103,13,75,88,20,10,9,48,43,228
1461,Kris Jenkins,SO,2014-15,F,Villanova,Big East,36,668,67,161,19,32,48,129,46,59,16,57,73,34,23,8,21,59,228
1462,Jelan Kendrick,SR,2014-15,G,Nevada-Las Vegas,MWC,32,842,85,206,62,142,23,64,35,57,20,114,134,94,27,11,49,59,228
1463,Tshilidzi Nephawe,SR,2014-15,C,New Mexico State,WAC,22,584,80,153,80,153,0,0,68,109,60,107,167,23,6,14,52,54,228
1464,Denzel Richardson,JR,2014-15,G,Eastern Kentucky,OVC,33,646,76,182,42,88,34,94,42,56,22,82,104,21,20,1,41,40,228
1465,Bira Seck,SR,2014-15,F,Idaho,Big Sky,30,703,97,184,96,183,1,1,33,50,61,140,201,30,15,8,55,103,228
1466,Ridge Shipley,SO,2014-15,G,Cal Poly,Big West,27,703,72,201,27,67,45,134,39,52,9,43,52,59,16,1,36,39,228
1467,C.J. Washington,SR,2014-15,F,Alabama-Birmingham,CUSA,34,603,84,223,69,167,15,56,45,62,53,76,129,15,20,10,48,66,228
1468,Reggie Arceneaux,SR,2014-15,G,Wright State,Horizon,31,821,82,230,38,96,44,134,19,26,7,43,50,66,22,0,32,33,227
1469,Mason Archie,JR,2014-15,G,IUPUI,Summit,30,741,80,208,47,103,33,105,34,46,17,34,51,36,20,0,49,61,227
1470,Eric Cooper,FR,2014-15,G,Nevada,MWC,31,736,73,245,35,97,38,148,43,55,20,47,67,42,24,1,51,43,227
1471,Delbert Love,SR,2014-15,G,Kennesaw State,A-Sun,32,912,80,231,49,117,31,114,36,49,38,90,128,83,35,2,62,34,227
1472,Justin Goldsborough,JR,2014-15,F,Lehigh,Patriot,30,702,93,160,93,160,0,0,40,66,58,115,173,18,12,38,48,78,226
1473,Wesley Gordon,SO,2014-15,F,Colorado,Pac-12,34,894,83,151,79,137,4,14,56,84,87,146,233,40,13,47,40,67,226
1474,Daniel Grieves,JR,2014-15,G,Southeastern Louisiana,Southland,30,763,79,177,54,100,25,77,43,68,45,89,134,30,30,10,57,94,226
1475,Andrew Nicholas,SR,2014-15,G,Monmouth,MAAC,29,750,81,224,38,100,43,124,21,30,22,74,96,41,22,12,28,76,226
1476,Timajh Parker-Rivera,SO,2014-15,F,Towson,CAA,32,900,81,182,81,175,0,7,64,123,74,115,189,42,21,29,56,93,226
1477,Nick Smith,SO,2014-15,F,Belmont,OVC,33,497,77,187,19,39,58,148,14,14,26,40,66,9,4,7,19,42,226
1478,T.J. Taylor,SR,2014-15,G,North Texas,CUSA,27,781,78,183,49,98,29,85,41,55,18,70,88,62,27,6,59,32,226
1479,Matt Townsend,SR,2014-15,F,Yale,Ivy,30,827,96,182,95,175,1,7,33,53,47,63,110,46,11,7,43,67,226
1480,Phil Valenti,SO,2014-15,F,Canisius,MAAC,24,602,85,190,73,154,12,36,44,62,41,68,109,58,23,7,45,64,226
1481,Adam Wing,JR,2014-15,G,Evansville,MVC,30,825,83,159,74,137,9,22,51,63,25,88,113,56,26,5,57,73,226
1482,Nick Zeisloft,JR,2014-15,G,Indiana,Big Ten,34,665,75,158,12,18,63,140,13,17,22,54,76,22,11,2,14,72,226
1483,Ahmad Abdullah,JR,2014-15,G,North Carolina A&amp;T,MEAC,32,925,81,201,56,130,25,71,38,52,14,75,89,82,28,3,58,59,225
1484,Isaac Copeland,FR,2014-15,F,Georgetown,Big East,33,661,83,184,62,130,21,54,38,47,30,97,127,23,8,19,36,46,225
1485,Tra Holder,FR,2014-15,G,Arizona State,Pac-12,32,865,58,183,46,133,12,50,97,137,9,60,69,115,16,0,80,57,225
1486,JaJuan Johnson,FR,2014-15,G,Marquette,Big East,31,673,84,225,68,152,16,73,41,55,15,66,81,55,34,11,49,34,225
1487,Jeremiah Jones,JR,2014-15,G,Duquesne,A-10,31,923,78,213,58,146,20,67,49,76,52,89,141,101,17,5,62,59,225
1488,Dan Kimasa,FR,2014-15,F,Texas-Pan American,WAC,31,859,82,198,82,198,0,0,61,102,56,145,201,18,15,44,31,73,225
1489,Ryan Oliver,JR,2014-15,G,Siena,MAAC,31,748,74,175,35,64,39,111,38,50,23,68,91,42,34,4,30,67,225
1490,Darryl Palmer,JR,2014-15,F,South Carolina State,MEAC,30,811,90,217,89,206,1,11,44,75,64,138,202,25,16,66,24,74,225
1491,Kasey Wilson,SR,2014-15,F,Central Florida,AAC,29,680,78,188,51,106,27,82,42,62,38,104,142,30,11,16,42,73,225
1492,Kris Acox,SO,2014-15,F,Furman,Southern,32,889,91,152,91,152,0,0,42,84,109,132,241,12,20,15,48,83,224
1493,Nick Hornsby,SO,2014-15,G-F,Sacramento State,Big Sky,33,806,87,185,83,175,4,10,46,72,46,126,172,54,44,11,56,84,224
1494,Vic Law,FR,2014-15,F,Northwestern,Big Ten,32,780,74,191,47,115,27,76,49,64,31,122,153,41,21,15,48,76,224
1495,Miles Wright,FR,2014-15,G,Dartmouth,Ivy,29,609,81,191,54,113,27,78,35,54,33,50,83,9,42,3,26,56,224
1496,Gary Browne,SR,2014-15,G,West Virginia,Big 12,32,644,61,163,31,85,30,78,71,102,22,40,62,46,39,0,40,58,223
1497,Wesley Davis,SR,2014-15,G,Texas State,Sun Belt,29,834,82,206,61,127,21,79,38,55,23,70,93,57,55,5,44,74,223
1498,Kassius Robertson,FR,2014-15,G,Canisius,MAAC,33,631,74,156,45,80,29,76,46,55,27,45,72,37,15,1,25,42,223
1499,Adam Woodbury,JR,2014-15,C,Iowa,Big Ten,34,697,87,178,87,178,0,0,49,85,68,108,176,30,19,13,47,92,223
1500,David Blanks,JR,2014-15,G,Texas Southern,SWAC,34,780,70,140,52,94,18,46,64,96,28,86,114,55,20,0,43,46,222
1501,Khary Doby,SO,2014-15,F,North Carolina A&amp;T,MEAC,32,717,75,202,53,124,22,78,50,79,32,79,111,15,12,15,48,64,222
1502,Toby Hegner,FR,2014-15,F,Creighton,Big East,33,632,72,172,27,47,45,125,33,40,27,84,111,25,5,12,26,73,222
1503,Jalen Hudson,FR,2014-15,G,Virginia Tech,ACC,32,535,80,167,65,114,15,53,47,73,23,40,63,37,17,10,51,58,222
1504,Keaton Jackson,JR,2014-15,F,Southern Illinois-Edwardsville,OVC,28,568,91,163,91,163,0,0,40,67,76,92,168,13,8,58,45,99,222
1505,Ryan Manuel,SR,2014-15,G,Southern Methodist,AAC,34,983,77,152,73,141,4,11,64,108,25,88,113,72,19,13,39,78,222
1506,James McGee,FR,2014-15,G,Southern Utah,Big Sky,27,467,70,143,9,23,61,120,21,30,7,33,40,36,11,2,16,49,222
1507,Dakarai Tucker,JR,2014-15,G-F,Utah,Pac-12,31,627,73,167,33,56,40,111,36,44,14,59,73,18,12,9,25,36,222
1508,Daiquan Walker,JR,2014-15,G,Central Florida,AAC,30,702,83,211,46,115,37,96,19,26,7,48,55,55,22,8,47,46,222
1509,Jaylen Adams,FR,2014-15,G,St. Bonaventure,A-10,22,714,61,158,27,53,34,105,65,83,6,49,55,99,25,1,43,47,221
1510,Josh Gray,JR,2014-15,G,Louisiana State,SEC,31,770,86,217,72,164,14,53,35,60,13,53,66,118,31,1,81,61,221
1511,Angel Matias,JR,2014-15,F,Georgia Southern,Sun Belt,27,702,90,182,86,168,4,14,37,54,65,87,152,50,23,11,45,62,221
1512,Kevin Vannatta,FR,2014-15,G,North Carolina-Asheville,Big South,29,753,71,149,43,77,28,72,51,72,22,81,103,72,29,0,41,34,221
1513,Jaylen Allen,FR,2014-15,G,Wofford,Southern,35,618,75,171,35,76,40,95,30,43,16,45,61,25,29,3,33,60,220
1514,Aaron Calixte,FR,2014-15,G,Maine,AEC,30,956,84,209,65,137,19,72,33,40,19,61,80,101,14,2,85,71,220
1515,Omega Harris,FR,2014-15,G,Texas-El Paso,CUSA,33,882,74,195,43,109,31,86,41,54,9,58,67,62,28,4,65,54,220
1516,Kevin Hervey,FR,2014-15,F,Texas-Arlington,Sun Belt,31,673,78,212,49,100,29,112,35,49,59,126,185,23,19,8,42,63,220
1517,Kevin Johnson,SO,2014-15,G,Cincinnati,AAC,34,742,74,195,31,72,43,123,29,44,6,40,46,45,28,4,54,68,220
1518,Sabri Thompson,SO,2014-15,G,Northwestern State,Southland,31,624,75,186,39,93,36,93,34,44,31,69,100,49,23,9,37,54,220
1519,Craig Bowman,FR,2014-15,G,Florida A&amp;M,MEAC,29,747,68,210,55,154,13,56,70,100,13,62,75,57,35,2,70,58,219
1520,DeAndre Haywood,SO,2014-15,G,Delaware State,MEAC,35,654,71,184,54,128,17,56,60,86,17,50,67,45,29,4,62,58,219
1521,Jaron Martin,SO,2014-15,G,California-Irvine,Big West,33,619,74,175,29,82,45,93,26,31,8,28,36,49,16,5,33,40,219
1522,Lotanna Nwogbo,JR,2014-15,F-C,Longwood,Big South,17,512,83,137,83,136,0,1,53,74,54,85,139,6,12,15,50,59,219
1523,Chris Ortiz,JR,2014-15,F,Kent State,MAC,35,798,71,180,54,113,17,67,60,86,43,114,157,18,19,13,41,66,219
1524,Brian Richardson,SR,2014-15,G,High Point,Big South,32,790,75,187,51,109,24,78,45,63,15,62,77,62,17,14,41,63,219
1525,Shaquille Thomas,JR,2014-15,F,Cincinnati,AAC,34,765,86,188,80,170,6,18,41,70,39,66,105,19,20,17,49,53,219
1526,Marques Townes,FR,2014-15,G,Fairleigh Dickinson,NEC,24,524,88,167,76,126,12,41,31,55,30,50,80,30,38,4,25,35,219
1527,Jordan Daniels,SR,2014-15,G,Drake,MVC,31,588,78,176,50,101,28,75,34,41,2,36,38,42,17,2,30,48,218
1528,Keith Davis,SR,2014-15,F,Southern,SWAC,35,731,87,170,87,170,0,0,44,81,53,89,142,13,15,38,54,107,218
1529,Amric Fields,SR,2014-15,F,Texas Christian,Big 12,29,537,83,175,69,128,14,47,38,82,28,75,103,22,8,20,25,49,218
1530,Anthony Glover,FR,2014-15,G,Chicago State,WAC,32,679,74,204,35,88,39,116,31,47,14,30,44,38,26,2,43,40,218
1531,Matt Hubbard,FR,2014-15,F,Santa Clara,WCC,32,729,80,195,52,106,28,89,30,42,41,86,127,18,7,10,40,65,218
1532,Tommie McCune,JR,2014-15,F,Oakland,Horizon,33,601,76,153,63,114,13,39,53,78,35,100,135,36,11,7,59,73,218
1533,Norense Odiase,FR,2014-15,F,Texas Tech,Big 12,31,673,82,162,81,161,1,1,53,110,71,74,145,26,10,20,51,89,218
1534,Godwin Okonji,SR,2014-15,F,Loyola Marymount,WCC,30,824,75,184,75,184,0,0,68,104,89,78,167,32,40,8,52,86,218
1535,Marcus Tarrance,SR,2014-15,G,Middle Tennessee,CUSA,36,733,65,154,32,66,33,88,55,77,34,47,81,29,19,1,34,69,218
1536,J.C. Hampton,SO,2014-15,G,Lipscomb,A-Sun,29,758,80,239,52,126,28,113,29,40,11,73,84,89,24,2,43,60,217
1537,Antino Jackson,FR,2014-15,G,Akron,MAC,35,600,76,214,38,92,38,122,27,37,10,43,53,56,20,1,52,58,217
1538,Justin Massey,FR,2014-15,G,Florida Atlantic,CUSA,29,734,69,165,31,71,38,94,41,59,10,78,88,38,18,2,30,58,217
1539,Rozell Nunn,SR,2014-15,G-F,Southern Illinois-Edwardsville,OVC,23,608,67,174,46,119,21,55,62,85,19,92,111,39,26,0,58,42,217
1540,Walter Pitchford,JR,2014-15,F,Nebraska,Big Ten,30,812,82,217,45,89,37,128,16,33,29,108,137,14,10,14,33,72,217
1541,Ben Bentil,FR,2014-15,F,Providence,Big East,34,730,75,172,66,142,9,30,57,82,79,87,166,21,9,12,40,89,216
1542,Elijah Minnie,FR,2014-15,F,Robert Morris,NEC,32,699,82,150,59,98,23,52,29,38,47,109,156,13,32,36,40,67,216
1543,D.J. Brown,SR,2014-15,G,Texas State,Sun Belt,30,911,63,170,20,49,43,121,46,59,9,70,79,81,33,0,41,54,215
1544,Chris Caird,SR,2014-15,G-F,Drake,MVC,31,618,72,162,29,61,43,101,28,32,16,48,64,32,10,2,38,61,215
1545,Dennis Clifford,JR,2014-15,C,Boston College,ACC,31,783,75,151,72,145,3,6,62,85,49,123,172,28,11,37,38,81,215
1546,Michael Messer,SR,2014-15,G,Southern Illinois-Edwardsville,OVC,28,604,84,183,60,124,24,59,23,37,33,53,86,23,17,3,37,72,215
1547,Nathan Moran,FR,2014-15,G,Lipscomb,A-Sun,26,560,63,181,12,33,51,148,38,50,9,39,48,68,17,0,48,57,215
1548,Tyler Rawson,FR,2014-15,F,Southern Utah,Big Sky,29,497,78,162,67,128,11,34,48,71,28,90,118,23,13,35,38,68,215
1549,Kendal Yancy,SO,2014-15,G,Texas,Big 12,34,724,76,189,48,105,28,84,35,45,28,67,95,59,9,5,37,42,215
1550,Michael Carrera,JR,2014-15,F,South Carolina,SEC,30,635,70,167,58,128,12,39,62,88,65,107,172,12,12,20,32,88,214
1551,Cannen Cunningham,SR,2014-15,C,Southern Methodist,AAC,34,546,86,157,85,150,1,7,41,55,35,85,120,18,19,21,38,65,214
1552,Carson Desrosiers,SR,2014-15,F,Providence,Big East,32,804,75,167,69,152,6,15,58,80,49,91,140,27,11,79,29,94,214
1553,Shawn Johnson,FR,2014-15,G,Incarnate Word,Southland,29,699,67,150,40,79,27,71,53,74,24,103,127,23,33,26,28,74,214
1554,Steve McClellan,SR,2014-15,F,Cal State Fullerton,Big West,31,786,90,162,90,162,0,0,34,52,82,169,251,20,11,10,42,89,214
1555,Paul Miller,FR,2014-15,G,North Dakota State,Summit,32,912,67,177,30,80,37,97,43,56,9,113,122,32,18,3,26,56,214
1556,Jeff Newberry,JR,2014-15,G,Oklahoma State,Big 12,32,672,70,169,42,90,28,79,46,57,23,50,73,45,29,12,33,59,214
1557,Casey Oliverson,JR,2014-15,F,Southern Utah,Big Sky,29,618,98,160,98,159,0,1,18,42,42,78,120,11,11,9,32,65,214
1558,Brian White,SO,2014-15,F,Citadel,Southern,30,641,73,123,73,123,0,0,68,80,37,91,128,9,10,6,25,59,214
1559,Michael Bradley,SR,2014-15,C,Samford,Southern,32,628,82,138,82,138,0,0,49,65,58,114,172,14,12,24,42,85,213
1560,Karonn Davis,FR,2014-15,G,Niagara,MAAC,29,886,67,197,32,89,35,108,44,58,16,65,81,81,18,3,31,70,213
1561,Andrew Drone,SO,2014-15,C,Rice,CUSA,32,726,82,143,82,143,0,0,49,73,56,116,172,14,10,21,52,67,213
1562,Nnanna Egwu,SR,2014-15,F-C,Illinois,Big Ten,33,982,85,197,75,164,10,33,33,42,84,112,196,33,26,59,36,99,213
1563,L.G. Gill,SO,2014-15,F,Duquesne,A-10,31,620,80,202,44,93,36,109,17,29,41,87,128,29,14,18,28,75,213
1564,Austin McBroom,JR,2014-15,G,Saint Louis,A-10,32,645,69,183,27,85,42,98,33,43,10,29,39,52,24,0,35,28,213
1565,Jared Nickens,FR,2014-15,G-F,Maryland,Big Ten,35,674,71,188,14,42,57,146,14,19,12,37,49,14,9,8,11,29,213
1566,Romone Saunders,FR,2014-15,G,Wagner,NEC,27,622,71,187,42,101,29,86,42,57,38,72,110,41,23,0,33,59,213
1567,Anthony Stitt,SR,2014-15,G,College of Charleston,CAA,26,824,76,235,48,148,28,87,33,56,20,48,68,66,26,3,62,53,213
1568,Cam Ward,FR,2014-15,G,Vermont,AEC,34,688,67,154,30,60,37,94,42,73,9,57,66,73,14,5,25,37,213
1569,Devin Wilson,SO,2014-15,G,Virginia Tech,ACC,33,990,63,140,55,113,8,27,79,112,13,84,97,140,29,2,63,69,213
1570,Obij Aget,SO,2014-15,C,New Mexico,MWC,31,765,81,145,81,145,0,0,50,77,60,108,168,8,16,42,43,80,212
1571,Kelton Ford,SO,2014-15,G,Troy,Sun Belt,29,744,65,183,45,100,20,83,62,100,4,63,67,68,51,4,63,72,212
1572,Johnny Hill,JR,2014-15,G,Texas-Arlington,Sun Belt,21,565,69,149,61,117,8,32,66,96,21,70,91,75,26,3,65,48,212
1573,Jalen Pendleton,JR,2014-15,G,Southern Illinois,MVC,32,710,74,173,70,156,4,17,60,90,33,61,94,51,34,1,36,68,212
1574,Devin Robinson,FR,2014-15,F,Florida,SEC,33,628,78,194,57,112,21,82,35,55,27,65,92,23,17,13,31,57,212
1575,Terrance Syon,SR,2014-15,F,New Orleans,Southland,28,656,82,157,82,157,0,0,48,85,66,93,159,14,16,12,54,94,212
1576,Brett Wishon,SO,2014-15,F,Lipscomb,A-Sun,29,698,70,195,17,43,53,152,19,25,24,81,105,62,12,9,43,54,212
1577,Geoff Beans,FR,2014-15,F,Furman,Southern,27,577,60,168,14,32,46,136,45,53,8,51,59,11,10,6,13,67,211
1578,Jarvis Garrett,FR,2014-15,G,Rhode Island,A-10,33,852,63,186,39,99,24,87,61,91,9,68,77,93,31,1,45,61,211
1579,Cameron Johnson,FR,2014-15,G,College of Charleston,CAA,33,895,72,180,37,90,35,90,32,43,13,70,83,38,21,3,42,90,211
1580,Aaron Armstead,SR,2014-15,G,Northern Illinois,MAC,29,607,77,171,40,82,37,89,19,30,19,44,63,20,31,2,36,64,210
1581,Phil Booth,FR,2014-15,G,Villanova,Big East,36,521,72,128,40,62,32,66,34,46,9,46,55,51,10,1,27,52,210
1582,Malcolm Brent,FR,2014-15,G,Maryland-Baltimore County,AEC,30,846,68,198,20,67,48,131,26,32,16,61,77,34,22,2,56,45,210
1583,Max DiLeo,SR,2014-15,G,Monmouth,MAAC,33,823,63,161,41,87,22,74,62,87,25,73,98,49,47,4,30,71,210
1584,Cody Doolin,SR,2014-15,G,Nevada-Las Vegas,MWC,33,1035,75,162,52,93,23,69,37,53,13,81,94,128,34,1,35,68,210
1585,Mareik Isom,SO,2014-15,G-F,Arkansas-Little Rock,Sun Belt,31,494,68,148,32,68,36,80,38,44,25,65,90,11,10,11,25,72,210
1586,Brice Kofane,SR,2014-15,F,Monmouth,MAAC,33,820,82,173,82,173,0,0,46,75,73,120,193,15,14,55,77,109,210
1587,Deion Lavender,FR,2014-15,G,Southern Illinois,MVC,32,734,74,171,50,95,24,76,38,46,9,71,80,26,14,1,36,33,210
1588,Rashann London,FR,2014-15,G,Drexel,CAA,30,910,85,226,71,174,14,52,26,41,7,56,63,47,20,3,55,68,210
1589,Reggis Onwukamuche,SR,2014-15,C,Prairie View,SWAC,33,817,78,148,78,148,0,0,54,92,79,95,174,8,18,57,49,123,210
1590,Jalyn Patterson,FR,2014-15,G,Louisiana State,SEC,31,764,75,184,31,66,44,118,16,19,13,62,75,68,37,4,26,27,210
1591,Jaleel Roberts,SR,2014-15,C,North Carolina-Asheville,Big South,30,578,94,153,94,153,0,0,22,36,54,97,151,12,8,78,38,86,210
1592,Amir Williams,SR,2014-15,C,Ohio State,Big Ten,33,644,76,115,76,115,0,0,58,92,53,101,154,11,22,52,34,72,210
1593,Aubrey Dawkins,FR,2014-15,G-F,Michigan,Big Ten,30,620,75,157,36,68,39,89,20,23,22,41,63,11,10,7,19,49,209
1594,Xavier Richards,JR,2014-15,G,Tennessee State,OVC,31,707,81,171,81,170,0,1,47,89,51,94,145,43,18,24,51,71,209
1595,Kavon Stewart,SO,2014-15,G,Robert Morris,NEC,34,964,61,179,48,133,13,46,74,118,15,68,83,156,56,1,85,61,209
1596,Tyler Ulis,FR,2014-15,G,Kentucky,SEC,37,882,67,165,34,88,33,77,42,52,16,51,67,135,37,2,38,56,209
1597,Mitchell Wilbekin,FR,2014-15,G,Wake Forest,ACC,29,815,65,179,16,52,49,127,30,41,10,57,67,47,31,2,26,51,209
1598,Jarod Williams,SO,2014-15,G,Detroit Mercy,Horizon,33,673,74,168,59,127,15,41,46,71,32,59,91,63,40,8,63,62,209
1599,Rakiya Battle,SO,2014-15,G,Alabama A&amp;M,SWAC,29,859,55,141,49,113,6,28,92,127,26,59,85,168,38,4,86,54,208
1600,Nate Britt,SO,2014-15,G,North Carolina,ACC,38,581,61,159,35,88,26,71,60,68,11,43,54,57,18,1,38,69,208
1601,Armani Cotton,SR,2014-15,G,Yale,Ivy,32,832,69,171,31,67,38,104,32,48,49,132,181,38,21,8,38,73,208
1602,Christian Mekowulu,FR,2014-15,F,Tennessee State,OVC,26,631,64,160,64,160,0,0,80,135,39,99,138,10,16,18,52,90,208
1603,Robert Upshaw,SO,2014-15,C,Washington,Pac-12,19,474,86,145,86,144,0,1,36,83,48,107,155,9,7,85,24,39,208
1604,Devon Williams,SO,2014-15,G-F,New Mexico,MWC,31,701,75,164,70,145,5,19,53,76,48,56,104,20,17,20,46,63,208
1605,Ben Wilson,JR,2014-15,G,Idaho State,Big Sky,30,1040,74,179,73,176,1,3,59,90,20,82,102,107,34,3,61,69,208
1606,Ray Bowles,FR,2014-15,G,Pacific,WCC,31,804,71,172,54,119,17,53,48,74,47,71,118,53,31,2,44,80,207
1607,James Demery,FR,2014-15,F,Saint Joseph's,A-10,31,752,78,213,71,173,7,40,44,78,53,57,110,32,23,13,44,56,207
1608,Thomas Jacobs,SR,2014-15,F,San Diego,WCC,31,668,79,154,77,139,2,15,47,63,61,99,160,11,25,6,33,65,207
1609,Brandan Kearney,SR,2014-15,F,Detroit Mercy,Horizon,33,685,74,169,48,97,26,72,33,46,16,57,73,57,25,4,47,68,207
1610,Hayward Register,SO,2014-15,G,Louisiana-Lafayette,Sun Belt,31,427,68,181,6,25,62,156,9,15,9,40,49,11,6,6,10,40,207
1611,Dontavious Sears,JR,2014-15,F,Lamar,Southland,29,409,77,168,44,71,33,97,20,30,28,62,90,10,18,4,17,34,207
1612,Dominique Williams,SO,2014-15,G,Florida International,CUSA,30,708,81,186,71,151,10,35,35,48,34,100,134,18,22,3,36,57,207
1613,Darrell Bowie,JR,2014-15,G-F,Northern Illinois,MAC,21,494,67,161,58,126,9,35,63,93,40,73,113,25,28,11,62,46,206
1614,JoJo Cooper,FR,2014-15,G,Wagner,NEC,30,856,62,172,45,109,17,63,65,100,22,78,100,121,33,1,82,72,206
1615,Justin Graham,SO,2014-15,G,Hartford,AEC,30,735,65,155,40,82,25,73,51,70,8,58,66,49,25,1,38,46,206
1616,Joell Hopkins,JR,2014-15,F,Southern,SWAC,32,599,75,141,75,138,0,3,56,90,42,59,101,9,19,15,36,65,206
1617,Malik Nichols,JR,2014-15,G-F,Hofstra,CAA,34,578,83,162,81,148,2,14,38,82,70,95,165,41,27,4,50,97,206
1618,E. Victor Nickerson,SR,2014-15,G-F,Valparaiso,Horizon,33,629,70,170,57,127,13,43,53,75,18,53,71,64,23,5,68,60,206
1619,London Perrantes,SO,2014-15,G,Virginia,ACC,32,1065,67,189,37,94,30,95,42,54,7,77,84,148,25,7,49,42,206
1620,Chris Perry,SO,2014-15,F-C,South Florida,AAC,19,496,85,173,85,171,0,2,36,61,37,98,135,12,15,24,41,56,206
1621,Jabari Sandifer,SO,2014-15,G,Western Illinois,Summit,28,822,72,201,51,131,21,70,41,68,7,77,84,119,25,6,61,72,206
1622,Marcel Smith,SR,2014-15,G,Houston Baptist,Southland,28,617,71,167,35,76,36,91,28,34,12,25,37,52,18,0,18,39,206
1623,Elijah Stewart,FR,2014-15,G,Southern California,Pac-12,32,705,74,198,37,91,37,107,21,31,17,60,77,22,31,37,36,82,206
1624,JaQuail Townser,JR,2014-15,G,Jacksonville State,OVC,26,737,72,200,51,130,21,70,41,55,10,56,66,87,33,5,64,69,206
1625,Dylan Chatman,SR,2014-15,G,Eastern Illinois,OVC,33,927,65,172,8,26,57,146,18,28,8,95,103,58,30,4,39,57,205
1626,David Humphries,JR,2014-15,G,Loyola Marymount,WCC,31,796,70,178,38,92,32,86,33,49,33,95,128,57,26,5,47,56,205
1627,Maurice Jeffers,SO,2014-15,F,Delaware,CAA,30,706,85,149,85,149,0,0,35,59,63,82,145,28,10,28,49,70,205
1628,Paul Jesperson,JR,2014-15,G,Northern Iowa,MVC,35,637,69,143,21,31,48,112,19,22,11,69,80,11,11,2,14,46,205
1629,Dexter Kernich-Drew,SR,2014-15,G,Washington State,Pac-12,31,587,69,165,27,68,42,97,25,32,14,35,49,18,4,5,29,55,205
1630,Justin McFadden,FR,2014-15,G-F,Binghamton,AEC,30,812,54,140,40,94,14,46,83,112,31,76,107,49,26,15,49,96,205
1631,Brian Pearson,JR,2014-15,F,Savannah State,MEAC,30,660,90,139,90,139,0,0,25,60,49,92,141,11,19,12,41,82,205
1632,Dorrian Williams,JR,2014-15,G,Missouri State,MVC,29,918,78,209,63,153,15,56,34,47,15,106,121,128,44,0,80,64,205
1633,Trevis Wyche,SO,2014-15,G,Saint Peter's,MAAC,34,927,61,159,43,100,18,59,65,94,19,82,101,114,41,0,56,79,205
1634,Landon Atterberry,SR,2014-15,F,Long Island University,NEC,27,540,78,192,59,136,19,56,29,42,42,77,119,11,11,13,25,56,204
1635,Trey Chapman,SO,2014-15,F,Virginia Military Institute,Southern,30,634,72,170,55,109,17,61,43,64,40,68,108,33,28,14,65,76,204
1636,Cam Gregory,FR,2014-15,F,Loyola (MD),Patriot,30,752,75,151,75,146,0,5,54,91,67,143,210,16,19,11,42,94,204
1637,Brandon Holcomb,JR,2014-15,C,Radford,Big South,34,722,83,147,83,147,0,0,38,55,60,94,154,28,13,49,53,74,204
1638,Bobby Hunter,SR,2014-15,G,Illinois State,MVC,30,585,70,159,34,71,36,88,28,40,17,42,59,42,19,0,31,46,204
1639,Mike Morsell,FR,2014-15,F,Towson,CAA,32,610,72,154,63,121,9,33,51,74,24,48,72,25,14,18,37,86,204
1640,Jordan Railey,SR,2014-15,C,Washington State,Pac-12,31,508,88,166,88,166,0,0,28,66,34,66,100,26,15,32,37,70,204
1641,Forrest Robinson,SR,2014-15,F,DePaul,Big East,32,635,68,167,22,41,46,126,22,25,25,78,103,11,11,18,27,83,204
1642,Derrick Walton,SO,2014-15,G,Michigan,Big Ten,19,633,55,159,26,78,29,81,65,78,8,81,89,57,23,1,35,33,204
1643,Namon Wright,FR,2014-15,G,Missouri,SEC,30,607,77,186,37,83,40,103,10,18,6,63,69,19,17,3,37,64,204
1644,Justin Edwards,JR,2014-15,G,Kansas State,Big 12,32,675,75,193,54,122,21,71,32,56,36,69,105,54,37,11,34,75,203
1645,Janarius Middleton,SO,2014-15,F,Jackson State,SWAC,25,470,87,171,77,136,10,35,19,26,59,63,122,20,13,11,26,45,203
1646,Malik Muller,FR,2014-15,G,Virginia Tech,ACC,33,661,72,184,31,77,41,107,18,32,7,74,81,47,29,3,44,56,203
1647,Jarquez Smith,SO,2014-15,F,Florida State,ACC,33,586,75,149,67,118,8,31,45,60,34,61,95,13,8,35,41,67,203
1648,John Brown,JR,2014-15,G,South Alabama,Sun Belt,32,644,72,167,53,105,19,62,39,56,21,46,67,30,21,18,44,53,202
1649,Perrion Callandret,SO,2014-15,G,Idaho,Big Sky,30,639,67,152,29,65,38,87,30,42,5,69,74,49,17,6,32,59,202
1650,MiKyle McIntosh,FR,2014-15,F,Illinois State,MVC,35,702,70,200,62,160,8,40,54,97,50,97,147,25,9,8,69,106,202
1651,Richaud Pack,SR,2014-15,G,Maryland,Big Ten,35,899,64,163,36,77,28,86,46,66,24,91,115,42,18,8,33,46,202
1652,Davell Roby,FR,2014-15,G,Saint Louis,A-10,31,768,62,168,37,91,25,77,53,85,16,71,87,55,29,1,51,70,202
1653,Karviar Shepherd,SO,2014-15,C,Texas Christian,Big 12,33,784,80,187,80,184,0,3,42,74,60,127,187,28,17,27,41,101,202
1654,Bryan Smith,SR,2014-15,G,Fordham,A-10,31,734,73,188,52,102,21,86,35,43,30,66,96,64,30,11,41,77,202
1655,Will Artino,SR,2014-15,C,Creighton,Big East,33,534,86,155,86,155,0,0,29,60,54,100,154,12,20,15,24,73,201
1656,Marco Banegas-Flores,SR,2014-15,G,Massachusetts-Lowell,AEC,27,747,62,164,31,82,31,82,46,58,9,59,68,52,50,1,55,51,201
1657,Keith Carter,JR,2014-15,G,Valparaiso,Horizon,24,662,74,161,42,75,32,86,21,31,12,72,84,89,30,6,43,48,201
1658,Brekkott Chapman,FR,2014-15,F,Utah,Pac-12,35,525,70,146,51,103,19,43,42,55,31,48,79,13,17,15,34,80,201
1659,Orlando Coleman,JR,2014-15,F,Kennesaw State,A-Sun,32,783,93,219,83,175,10,44,5,7,46,117,163,30,24,13,60,48,201
1660,Jordan Green,SR,2014-15,G,Texas A&amp;M,SEC,33,803,71,143,55,101,16,42,43,55,12,49,61,61,15,4,35,68,201
1661,Jon Horford,SR,2014-15,C,Florida,SEC,31,621,78,161,65,110,13,51,32,41,48,101,149,10,10,27,18,67,201
1662,Nick King,SO,2014-15,F-G,Memphis,AAC,28,528,74,183,68,159,6,24,47,74,51,83,134,28,16,9,29,41,201
1663,TySean Powell,FR,2014-15,F,Duquesne,A-10,29,413,77,133,77,133,0,0,47,72,32,62,94,8,11,15,34,64,201
1664,Quentin Bastian,SR,2014-15,F,Florida A&amp;M,MEAC,25,581,79,187,79,185,0,2,42,63,39,73,112,11,5,8,35,74,200
1665,Matt Bohannon,JR,2014-15,G,Northern Iowa,MVC,35,911,63,155,9,17,54,138,20,26,0,60,60,30,20,1,15,54,200
1666,Malcolm Canada,SR,2014-15,G,Auburn,SEC,35,777,61,166,52,120,9,46,69,100,14,78,92,69,38,14,45,100,200
1667,Eric Ferguson,SR,2014-15,F,Georgia Southern,Sun Belt,25,509,74,161,56,107,18,54,34,68,45,88,133,10,14,15,39,75,200
1668,Mindaugas Kacinas,JR,2014-15,F,South Carolina,SEC,33,710,74,132,65,103,9,29,43,59,77,91,168,18,20,14,34,82,200
1669,Josh Newkirk,SO,2014-15,G,Pittsburgh,ACC,34,704,75,199,53,126,22,73,28,42,8,37,45,93,17,0,49,72,200
1670,Will Regan,SR,2014-15,F,Buffalo,MAC,33,755,64,177,36,85,28,92,44,60,46,89,135,17,12,16,16,58,200
1671,Jordan Roper,JR,2014-15,G,Clemson,ACC,31,591,68,200,40,108,28,92,36,44,10,35,45,47,17,3,39,27,200
1672,Dmitri Thompson,FR,2014-15,G,Elon,CAA,33,619,84,179,79,156,5,23,27,55,27,95,122,14,23,1,32,48,200
1673,Clay Wilson,SR,2014-15,G,Princeton,Ivy,30,599,66,146,24,40,42,106,26,35,5,31,36,23,13,0,14,46,200
1674,Cliff Alexander,FR,2014-15,F,Kansas,Big 12,28,492,73,129,73,129,0,0,53,79,55,93,148,12,5,37,28,57,199
1675,Steve Frankoski,SR,2014-15,G,Columbia,Ivy,26,573,70,168,24,57,46,111,13,14,4,43,47,16,8,5,19,37,199
1676,Cullen Hamilton,JR,2014-15,G,Holy Cross,Patriot,30,611,73,186,47,109,26,77,27,33,27,44,71,26,15,0,26,27,199
1677,Avery Johnson,SR,2014-15,G,California-Davis,Big West,32,891,60,138,28,60,32,78,47,57,13,80,93,58,39,8,44,58,199
1678,Jake Kitchell,SR,2014-15,F-C,Indiana State,MVC,31,741,68,139,55,97,13,42,50,70,58,94,152,47,12,29,43,70,199
1679,Matt Mooney,FR,2014-15,G,Air Force,MWC,29,558,74,165,45,90,29,75,22,28,13,43,56,52,24,4,32,31,199
1680,Luther Page,SR,2014-15,F,Alabama State,SWAC,29,601,67,124,67,124,0,0,65,116,68,92,160,20,21,14,54,66,199
1681,Tevin Prescott,JR,2014-15,F,Winthrop,Big South,29,646,77,134,77,134,0,0,45,81,57,84,141,7,21,16,29,84,199
1682,Gavin Schilling,SO,2014-15,F,Michigan State,Big Ten,39,659,82,141,82,141,0,0,35,73,66,84,150,15,7,25,33,115,199
1683,J.T. Adenrele,JR,2014-15,F,California-Davis,Big West,31,562,76,153,75,152,1,1,45,67,47,75,122,20,14,16,44,90,198
1684,Anton Beard,FR,2014-15,G,Arkansas,SEC,35,662,66,172,35,84,31,88,35,55,31,36,67,53,35,0,32,84,198
1685,Georgi Boyanov,FR,2014-15,F,South Alabama,Sun Belt,33,582,72,145,62,108,10,37,44,77,47,107,154,18,22,11,32,69,198
1686,Brannen Greene,SO,2014-15,G,Kansas,Big 12,35,525,57,135,17,36,40,99,44,48,9,65,74,27,10,4,30,45,198
1687,Daquan Holiday,SR,2014-15,F,NJIT,Ind,33,618,78,123,78,123,0,0,42,71,48,103,151,28,25,49,32,94,198
1688,Chris Hooper,JR,2014-15,F,St. Francis (NY),NEC,35,500,76,147,76,147,0,0,46,79,66,81,147,26,19,16,41,82,198
1689,Devarick Houston,SR,2014-15,F,Maryland-Baltimore County,AEC,30,974,77,156,62,99,15,57,29,50,35,112,147,54,49,36,72,92,198
1690,Khalid Lewis,JR,2014-15,G,La Salle,A-10,33,907,74,198,53,134,21,64,29,47,6,59,65,72,33,8,53,57,198
1691,Brandon Roberts,SO,2014-15,G,Samford,Southern,32,415,71,180,38,81,33,99,23,30,11,26,37,31,17,0,29,30,198
1692,Evan Taylor,FR,2014-15,G,Samford,Southern,31,693,74,190,60,149,14,41,36,58,23,80,103,37,33,7,47,57,198
1693,Manny Thomas,SR,2014-15,G-F,Marist,MAAC,32,851,52,157,12,44,40,113,54,66,12,63,75,39,26,7,44,61,198
1694,Bo Zeigler,FR,2014-15,G-F,South Florida,AAC,31,753,83,164,83,161,0,3,32,78,41,97,138,16,11,35,46,92,198
1695,Michael Cobbins,SR,2014-15,F,Oklahoma State,Big 12,29,792,78,134,78,134,0,0,41,72,49,122,171,16,20,53,33,79,197
1696,Trey Kell,FR,2014-15,G,San Diego State,MWC,35,709,62,186,47,118,15,68,58,91,19,79,98,56,20,3,38,33,197
1697,McKay LaSalle,SR,2014-15,G,Long Beach State,Big West,33,760,66,170,11,19,55,151,10,13,5,42,47,23,15,0,14,64,197
1698,Jeremy Morgan,SO,2014-15,G,Northern Iowa,MVC,35,821,64,151,33,58,31,93,38,52,27,81,108,30,40,19,17,63,197
1699,Ryan Rhoomes,JR,2014-15,F,Fordham,A-10,31,924,77,139,77,139,0,0,43,64,104,164,268,26,12,40,38,78,197
1700,Collin Stewart,SO,2014-15,G,Monmouth,MAAC,33,469,67,153,44,86,23,67,40,58,5,32,37,25,14,9,41,47,197
1701,Derrell Taylor,SR,2014-15,F,Jackson State,SWAC,26,592,69,133,69,133,0,0,59,78,58,67,125,16,27,5,31,68,197
1702,LeTrell Viser,JR,2014-15,G,Eastern Illinois,OVC,32,730,71,194,27,62,44,132,11,21,6,74,80,34,40,15,39,70,197
1703,Lenny Antwi,SR,2014-15,G,North Dakota,Big Sky,29,618,65,154,25,56,40,98,26,31,4,37,41,29,12,0,17,41,196
1704,V.J. Beachem,SO,2014-15,F,Notre Dame,ACC,33,483,66,145,24,44,42,101,22,29,10,37,47,15,8,8,18,28,196
1705,Jalen Carethers,SR,2014-15,F,Radford,Big South,34,531,77,153,77,153,0,0,42,58,57,81,138,23,19,23,22,84,196
1706,Marvin Frazier,SR,2014-15,C,Northwestern State,Southland,24,557,73,154,58,116,15,38,35,56,43,82,125,27,21,51,33,64,196
1707,Stefan Jovanovic,SO,2014-15,C,Hawaii,Big West,34,590,71,147,71,147,0,0,54,71,48,78,126,10,11,28,31,90,196
1708,RaShawn Stores,SR,2014-15,G,Manhattan,MAAC,31,803,54,145,15,47,39,98,49,69,13,44,57,93,39,0,32,90,196
1709,Deandre Burnett,FR,2014-15,G,Miami (FL),ACC,28,488,64,180,36,84,28,96,39,53,13,43,56,18,14,4,24,32,195
1710,Eric Green,JR,2014-15,G-F,Holy Cross,Patriot,30,699,86,199,86,195,0,4,23,43,26,71,97,27,43,19,36,63,195
1711,Marcus Johnson,JR,2014-15,G,Samford,Southern,32,610,66,148,36,65,30,83,33,49,13,51,64,54,23,2,35,33,195
1712,Saadiq Muhammad,SO,2014-15,F,Savannah State,MEAC,30,626,78,170,78,169,0,1,39,78,42,76,118,12,17,16,48,85,195
1713,Jervon Pressley,JR,2014-15,F,Hampton,MEAC,32,688,70,158,70,158,0,0,55,101,62,92,154,21,12,44,62,95,195
1714,Johnathan Stove,FR,2014-15,G,Louisiana-Lafayette,Sun Belt,36,674,70,141,63,117,7,24,48,61,27,47,74,65,14,12,42,82,195
1715,T.J. Buchanan,SR,2014-15,G,Rhode Island,A-10,33,744,61,127,58,118,3,9,69,103,33,77,110,84,40,7,49,84,194
1716,Travis Daniels,JR,2014-15,G,Mississippi State,SEC,32,632,70,176,46,93,24,83,30,45,39,85,124,18,14,5,49,52,194
1717,Max Hooper,JR,2014-15,G-F,Oakland,Horizon,33,618,64,167,4,8,60,159,6,8,4,39,43,9,9,1,12,32,194
1718,Zach Mills,SR,2014-15,F,Sacramento State,Big Sky,33,656,73,157,45,97,28,60,20,28,29,76,105,22,19,2,20,50,194
1719,Dylan Osetkowski,FR,2014-15,C,Tulane,AAC,31,687,77,152,71,140,6,12,34,71,68,81,149,26,18,10,40,76,194
1720,John Carroll,FR,2014-15,F,Hartford,AEC,30,450,64,174,58,154,6,20,59,88,43,54,97,8,6,5,35,59,193
1721,Jadon Cohee,FR,2014-15,G,Seattle,WAC,34,625,71,184,60,149,11,35,40,56,4,52,56,51,13,0,46,37,193
1722,Tim Douglas,SR,2014-15,G,Portland State,Big Sky,29,685,62,162,35,86,27,76,42,50,9,49,58,80,24,2,33,49,193
1723,Josh Gentry,SR,2014-15,G,Cal State Fullerton,Big West,31,732,58,132,52,102,6,30,71,78,21,55,76,41,17,8,48,52,193
1724,Drake LaMont,FR,2014-15,C,Western Michigan,MAC,34,727,78,163,78,163,0,0,37,54,59,87,146,12,14,25,22,87,193
1725,Anali Okoloji,SR,2014-15,F,Eastern Michigan,MAC,35,588,67,172,58,134,9,38,50,66,46,86,132,22,31,11,33,41,193
1726,Zach Smith,FR,2014-15,F,Texas Tech,Big 12,31,858,68,144,63,125,5,19,52,84,50,103,153,42,18,45,36,67,193
1727,Jonathan Gilling,SR,2014-15,F,Arizona State,Pac-12,34,703,62,142,7,14,55,128,13,20,6,72,78,35,11,5,39,55,192
1728,Zalmico Harmon,SR,2014-15,G,California-Santa Barbara,Big West,31,981,54,155,27,81,27,74,57,70,16,33,49,108,19,5,49,70,192
1729,Payton Henson,SO,2014-15,F,Tulane,AAC,31,576,64,163,53,107,11,56,53,79,50,70,120,20,12,12,30,42,192
1730,J.P. Kambola,SR,2014-15,C,Marshall,CUSA,29,478,78,142,67,97,11,45,25,36,50,75,125,5,8,28,30,54,192
1731,Kristijan Krajina,SR,2014-15,F,Mount St. Mary's,NEC,30,650,79,183,76,158,3,25,31,51,55,86,141,18,12,18,42,77,192
1732,Lamond Murray,SO,2014-15,G-F,Pepperdine,WCC,28,519,80,172,78,165,2,7,30,37,24,62,86,26,15,9,34,48,192
1733,Earl Potts,FR,2014-15,G-F,Fairleigh Dickinson,NEC,29,527,67,162,53,104,14,58,44,63,22,61,83,14,21,9,13,85,192
1734,Derek Reese,JR,2014-15,G,Tennessee,SEC,32,810,65,160,45,100,20,60,42,57,56,114,170,28,21,10,37,69,192
1735,Duda Sanadze,JR,2014-15,G,San Diego,WCC,29,511,63,181,41,107,22,74,44,65,18,53,71,24,14,7,37,49,192
1736,Sean Sheldon,JR,2014-15,F,William &amp; Mary,CAA,31,702,82,127,82,127,0,0,28,56,49,84,133,67,10,15,31,63,192
1737,J.T. Thomas,JR,2014-15,G,Arkansas-Little Rock,Sun Belt,31,796,61,177,32,88,29,89,41,69,3,52,55,75,14,5,33,40,192
1738,Andre Yates,SO,2014-15,G,Cleveland State,Horizon,32,705,71,170,45,88,26,82,24,38,21,32,53,26,45,3,31,82,192
1739,Jelani Currie,JR,2014-15,G,Texas A&amp;M-Corpus Christi,Southland,33,671,63,131,46,94,17,37,48,68,29,65,94,28,22,14,30,56,191
1740,Nick Gruninger,SR,2014-15,G,California-Riverside,Big West,31,722,62,147,40,77,22,70,45,48,7,46,53,101,22,0,53,63,191
1741,Makai Mason,FR,2014-15,G,Yale,Ivy,31,595,63,139,46,91,17,48,48,66,14,55,69,49,20,2,33,52,191
1742,Erick Neal,FR,2014-15,G,Texas-Arlington,Sun Belt,29,537,66,167,31,60,35,107,24,37,7,46,53,86,34,0,59,38,191
1743,Retin Obasohan,JR,2014-15,G,Alabama,SEC,31,604,67,150,50,105,17,45,40,66,21,68,89,24,28,16,35,67,191
1744,Jaysean Paige,JR,2014-15,G,West Virginia,Big 12,34,452,68,168,33,77,35,91,20,38,36,27,63,22,37,5,31,77,191
1745,Julion Pearre,FR,2014-15,G,Utah State,MWC,31,727,63,180,27,75,36,105,29,39,4,60,64,51,21,2,38,63,191
1746,Michael Perez,SR,2014-15,G,Nevada,MWC,30,803,66,203,44,120,22,83,37,55,9,82,91,58,31,3,46,58,191
1747,Ricky Doyle,FR,2014-15,F,Michigan,Big Ten,31,564,74,121,74,121,0,0,42,69,46,52,98,8,7,12,18,57,190
1748,Jonathan Fairell,SR,2014-15,F,Murray State,OVC,35,744,78,143,78,143,0,0,34,76,102,142,244,29,32,28,50,111,190
1749,Will Kelly,JR,2014-15,F-C,Navy,Patriot,31,633,70,131,70,131,0,0,50,90,47,84,131,24,7,57,41,83,190
1750,Emmett Naar,FR,2014-15,G,Saint Mary's (CA),WCC,30,842,54,137,19,59,35,78,47,59,8,51,59,118,13,2,61,42,190
1751,Michel Nzege,SO,2014-15,F,East Carolina,AAC,33,608,85,138,85,138,0,0,20,42,58,96,154,20,16,12,36,61,190
1752,Isaiah Zierden,SO,2014-15,G,Creighton,Big East,20,558,55,139,11,28,44,111,36,40,3,42,45,29,12,1,13,25,190
1753,Ka'Darryl Bell,JR,2014-15,G,Bradley,MVC,31,808,58,169,37,110,21,59,52,77,19,53,72,66,30,3,59,86,189
1754,Gaellen Bewernick,JR,2014-15,F,Northern Arizona,Big Sky,37,889,80,173,73,138,7,35,22,34,41,142,183,37,17,4,55,58,189
1755,Jaylon Brown,SO,2014-15,G,Evansville,MVC,36,694,67,142,58,117,9,25,46,60,6,62,68,88,26,4,48,75,189
1756,Que Johnson,SO,2014-15,G,Washington State,Pac-12,31,559,60,155,32,78,28,77,41,48,15,56,71,32,10,4,33,55,189
1757,Chris Kendrix,FR,2014-15,G-F,Missouri State,MVC,30,708,53,128,33,66,20,62,63,83,41,70,111,25,18,11,38,54,189
1758,Jake Kretzer,JR,2014-15,F,Akron,MAC,34,810,57,143,14,26,43,117,32,35,41,96,137,38,28,2,22,77,189
1759,Reggie Spencer,SR,2014-15,F,Northeastern,CAA,32,604,70,132,70,132,0,0,49,61,32,66,98,23,20,15,39,84,189
1760,Kam Williams,FR,2014-15,G,Ohio State,Big Ten,35,500,70,155,42,74,28,81,21,23,6,28,34,18,17,2,6,22,189
1761,Amdy Fall,JR,2014-15,F,St. Francis (NY),NEC,29,676,56,116,56,116,0,0,76,108,55,89,144,19,22,80,38,83,188
1762,Michael Kessens,SO,2014-15,F,Alabama,SEC,32,677,73,146,71,134,2,12,40,61,54,111,165,26,17,13,56,95,188
1763,J.P. Macura,FR,2014-15,G,Xavier,Big East,35,463,62,150,30,55,32,95,32,42,15,27,42,22,26,3,33,50,188
1764,Cory Osetkowski,SR,2014-15,C,Columbia,Ivy,27,643,67,160,62,128,5,32,49,78,61,88,149,54,8,20,56,63,188
1765,Jimmie Taylor,SO,2014-15,F,Alabama,SEC,34,801,71,118,71,118,0,0,46,93,55,113,168,17,9,59,40,94,188
1766,Steve Taylor,JR,2014-15,F,Marquette,Big East,32,707,80,166,72,135,8,31,20,40,62,99,161,14,17,5,29,46,188
1767,Ross Travis,SR,2014-15,F,Penn State,Big Ten,34,846,83,175,80,161,3,14,19,57,69,144,213,26,22,5,44,78,188
1768,Marko Vasic,JR,2014-15,F,American,Patriot,33,671,78,150,68,108,10,42,22,39,21,97,118,45,23,2,29,58,188
1769,Marcel White,SO,2014-15,G-F,Jacksonville,A-Sun,31,582,51,125,21,56,30,69,56,81,20,48,68,9,11,7,17,56,188
1770,Aaron Young,SO,2014-15,G,Oral Roberts,Summit,31,724,62,126,33,61,29,65,35,47,6,38,44,60,19,1,35,53,188
1771,Stedman Allen,JR,2014-15,F,Wagner,NEC,29,563,65,162,65,160,0,2,57,83,62,65,127,6,24,13,34,67,187
1772,Romelo Banks,SO,2014-15,C,North Florida,A-Sun,35,590,71,149,71,149,0,0,45,82,39,60,99,7,2,18,31,87,187
1773,Ryan Frazier,JR,2014-15,G,Bucknell,Patriot,34,761,50,127,32,78,18,49,69,92,8,46,54,62,17,3,32,61,187
1774,Phil Gaetano,SR,2014-15,G,Sacred Heart,NEC,32,989,55,160,11,42,44,118,33,36,13,85,98,185,28,3,84,69,187
1775,Jaron Hopkins,SO,2014-15,G,Colorado,Pac-12,32,670,73,153,60,114,13,39,28,52,22,85,107,42,32,4,55,66,187
1776,Xavier Lundy,SO,2014-15,F,Rider,MAAC,32,463,75,153,59,105,16,48,21,30,28,46,74,16,16,12,27,53,187
1777,Javier Martinez,SO,2014-15,F,Tennessee-Martin,OVC,33,514,78,111,78,111,0,0,31,41,59,67,126,6,8,6,18,67,187
1778,Marcus Owens,SO,2014-15,G-F,Lamar,Southland,30,624,61,176,26,64,35,112,30,46,41,68,109,15,22,3,27,71,187
1779,Ta'Jon Welcome,JR,2014-15,G,Northwestern State,Southland,32,504,72,168,50,87,22,81,21,39,18,49,67,32,17,10,28,54,187
1780,Yosef Yacob,SO,2014-15,G,Binghamton,AEC,32,730,53,157,24,57,29,100,52,69,6,27,33,38,19,1,53,52,187
1781,Richard Freeman,SO,2014-15,F,Grambling,SWAC,27,645,63,182,59,160,4,22,56,93,32,105,137,26,15,10,58,51,186
1782,Matt Glover,SR,2014-15,G,San Francisco,WCC,32,846,61,152,42,93,19,59,45,96,39,136,175,98,40,9,62,97,186
1783,DeAndre Harris,SO,2014-15,G,North Texas,CUSA,27,515,64,172,47,100,17,72,41,73,8,57,65,27,21,3,54,67,186
1784,Deontae Hawkins,FR,2014-15,F,Illinois State,MVC,25,560,70,184,40,91,30,93,16,21,32,99,131,21,11,9,23,45,186
1785,James Johnson,SR,2014-15,F,Liberty,Big South,32,569,79,148,79,148,0,0,28,51,35,62,97,9,7,10,65,89,186
1786,Abdel Nader,JR,2014-15,F,Iowa State,Big 12,32,524,69,170,54,101,15,69,33,43,22,71,93,23,12,16,37,50,186
1787,L.J. Rose,JR,2014-15,G,Houston,AAC,19,657,64,172,40,91,24,81,34,56,11,37,48,101,17,3,51,44,186
1788,Liam Thomas,SO,2014-15,F,Nicholls State,Southland,29,601,72,125,65,104,7,21,35,62,49,76,125,37,8,47,34,84,186
1789,Osandai Vaughn,SO,2014-15,G,Youngstown State,Horizon,28,572,60,143,40,96,20,47,46,61,27,59,86,18,20,9,24,57,186
1790,John Azzinaro,SO,2014-15,G,Bucknell,Patriot,34,566,60,180,15,60,45,120,20,26,9,45,54,34,11,1,25,57,185
1791,Dwight Coleby,SO,2014-15,C,Mississippi,SEC,34,560,67,126,67,126,0,0,51,64,66,98,164,2,6,29,25,76,185
1792,Tyrell Corbin,SR,2014-15,G,Cal State Bakersfield,WAC,33,732,57,154,33,86,24,68,47,60,16,59,75,74,30,2,62,36,185
1793,Alec Kobre,JR,2014-15,G,Pacific,WCC,31,525,56,147,11,24,45,123,28,30,5,24,29,14,6,1,15,56,185
1794,Eric Norman,SR,2014-15,F,Montana State,Big Sky,30,831,63,202,35,97,28,105,31,44,52,159,211,61,23,50,51,79,185
1795,Tashombe Riley,FR,2014-15,F,South Carolina State,MEAC,33,615,80,185,79,181,1,4,24,38,45,56,101,15,16,13,30,48,185
1796,Gabriel Aguirre,SR,2014-15,F,Pacific,WCC,24,595,67,134,67,134,0,0,50,90,30,64,94,20,4,4,34,53,184
1797,Aaron Bowen,SR,2014-15,F,Georgetown,Big East,33,496,74,140,65,110,9,30,27,52,26,41,67,32,28,8,36,51,184
1798,Keenan Evans,FR,2014-15,G,Texas Tech,Big 12,32,582,55,149,39,96,16,53,58,81,13,51,64,44,24,11,43,38,184
1799,Duane Gibson,SO,2014-15,G,Evansville,MVC,36,667,66,127,66,127,0,0,52,72,9,48,57,97,36,12,63,102,184
1800,Christian Hairston,SO,2014-15,G-F,Elon,CAA,33,636,73,118,73,117,0,1,38,55,38,92,130,22,21,4,47,80,184
1801,James Hunter,SR,2014-15,C,South Dakota,Summit,32,434,77,156,77,156,0,0,30,43,53,58,111,9,6,18,26,48,184
1802,Donte Ingram,FR,2014-15,G-F,Loyola (IL),MVC,37,677,71,159,49,100,22,59,20,31,26,90,116,23,10,5,25,59,184
1803,Chris Jenkins,SO,2014-15,G-F,Detroit Mercy,Horizon,23,493,63,140,40,90,23,50,35,52,32,76,108,24,17,6,26,49,184
1804,Kaleb Joseph,FR,2014-15,G,Syracuse,ACC,31,847,68,181,61,146,7,35,41,57,14,54,68,119,28,3,72,58,184
1805,Francis Kiapway,FR,2014-15,G,Ball State,MAC,28,734,60,161,10,35,50,126,14,20,10,40,50,29,11,0,27,45,184
1806,Clemmye Owens,SO,2014-15,G,Bethune-Cookman,MEAC,12,395,61,148,36,69,25,79,37,50,6,15,21,16,13,0,22,27,184
1807,David Skara,FR,2014-15,F,Valparaiso,Horizon,34,673,66,140,52,92,14,48,38,47,28,80,108,60,20,10,46,64,184
1808,Thatch Unruh,FR,2014-15,G,Central Arkansas,Southland,29,596,61,177,19,48,42,129,20,25,18,49,67,39,17,5,46,72,184
1809,Michael Weisner,SR,2014-15,F,Montana,Big Sky,28,640,59,156,22,52,37,104,29,37,10,55,65,42,24,7,35,75,184
1810,Mike Williams,FR,2014-15,G,Rutgers,Big Ten,29,643,66,206,42,106,24,100,28,36,20,45,65,34,21,15,20,60,184
1811,Dantiel Daniels,JR,2014-15,F,Colorado State,MWC,32,659,66,105,66,105,0,0,51,117,74,80,154,28,12,15,30,56,183
1812,Matt Kamieniecki,SR,2014-15,F,Ball State,MAC,22,466,60,123,59,122,1,1,62,112,52,100,152,18,20,15,32,73,183
1813,Isaac McGlone,SO,2014-15,G,Eastern Kentucky,OVC,33,953,64,164,22,41,42,123,13,20,7,67,74,86,56,2,36,71,183
1814,Cody Wichmann,SO,2014-15,G,Milwaukee,Horizon,30,669,62,150,15,33,47,117,12,15,17,51,68,32,19,8,21,52,183
1815,Rich Williams,SO,2014-15,G,Manhattan,MAAC,33,536,67,183,33,76,34,107,15,23,18,31,49,28,28,1,34,70,183
1816,Tre'Shaun Fletcher,SO,2014-15,G-F,Colorado,Pac-12,34,622,65,143,43,95,22,48,30,42,28,58,86,34,11,3,42,46,182
1817,Isaiah Johnson,SO,2014-15,C,Akron,MAC,34,625,65,135,65,135,0,0,52,93,50,89,139,31,14,36,45,63,182
1818,Bosko Kostur,FR,2014-15,G-F,Bryant,NEC,23,460,61,124,38,75,23,49,37,49,21,51,72,13,5,0,28,62,182
1819,Darius Leonard,SR,2014-15,F,Wake Forest,ACC,32,557,71,180,42,84,29,96,11,23,32,47,79,10,10,10,15,52,182
1820,Justin McBride,SO,2014-15,C,Central Florida,AAC,29,398,72,142,72,142,0,0,38,52,40,86,126,3,11,27,42,68,182
1821,Brandon Parrish,SO,2014-15,F,Texas Christian,Big 12,33,618,64,160,41,95,23,65,31,53,19,37,56,17,20,14,31,49,182
1822,Curtis Washington,SR,2014-15,F,Georgia State,Sun Belt,35,599,70,125,70,125,0,0,42,54,60,87,147,7,11,44,30,75,182
1823,Kevin Booze,FR,2014-15,G,Lamar,Southland,29,534,52,149,24,71,28,78,49,60,8,34,42,85,25,0,55,70,181
1824,Justin Browning,JR,2014-15,F,Western Carolina,Southern,31,775,64,116,56,90,8,26,45,62,44,94,138,49,45,27,48,117,181
1825,Darion Clark,SO,2014-15,F,Southern California,Pac-12,32,705,65,150,65,149,0,1,51,94,58,124,182,26,14,18,48,55,181
1826,Malcolm Drumwright,FR,2014-15,G,Jacksonville State,OVC,30,653,61,167,41,101,20,66,39,47,6,37,43,47,22,3,31,58,181
1827,Obi Enechionyia,FR,2014-15,F,Temple,AAC,34,635,66,147,54,104,12,43,37,47,45,79,124,14,11,45,17,81,181
1828,Kedren Johnson,JR,2014-15,G,Memphis,AAC,27,634,58,144,34,76,24,68,41,50,8,50,58,74,11,5,54,57,181
1829,Trey Norris,JR,2014-15,G,South Dakota,Summit,33,803,59,127,48,91,11,36,52,71,9,37,46,89,29,0,33,81,181
1830,Rob Ukawuba,SO,2014-15,G,NJIT,Ind,28,531,63,121,46,81,17,40,38,59,26,70,96,26,18,6,22,63,181
1831,Rodney Williams,SO,2014-15,F,Drexel,CAA,22,672,71,164,71,163,0,1,39,66,55,99,154,28,8,34,37,64,181
1832,Duje Dukan,SR,2014-15,F,Wisconsin,Big Ten,38,605,60,155,31,64,29,91,31,46,28,70,98,24,8,3,25,48,180
1833,Sean Hill,SR,2014-15,G,Chicago State,WAC,22,547,65,180,44,105,21,75,29,38,11,36,47,46,25,3,43,41,180
1834,Tra'von Joseph,SO,2014-15,G,Northwestern State,Southland,30,565,66,114,60,101,6,13,42,64,53,82,135,26,16,7,39,68,180
1835,Ishaq Pitt,SR,2014-15,G,Maryland-Eastern Shore,MEAC,33,830,64,137,63,132,1,5,51,99,35,89,124,137,38,6,71,61,180
1836,Dashawn Richmond,JR,2014-15,G,Cal State Bakersfield,WAC,29,463,59,147,33,80,26,67,36,50,19,54,73,19,17,3,30,65,180
1837,Quinton Stephens,SO,2014-15,F,Georgia Tech,ACC,30,566,67,194,35,87,32,107,14,19,32,54,86,13,15,13,21,38,180
1838,Jeremy Watson,JR,2014-15,F,Jacksonville State,OVC,31,646,50,128,47,119,3,9,77,107,62,96,158,9,10,7,27,37,180
1839,JaMarcus Weatherspoon,JR,2014-15,G,Texas State,Sun Belt,31,611,62,151,60,138,2,13,54,82,34,61,95,18,18,9,39,65,180
1840,Bonzie Colson,FR,2014-15,F,Notre Dame,ACC,32,386,66,111,65,104,1,7,46,61,27,59,86,13,19,22,14,42,179
1841,Keith Frazier,SO,2014-15,G,Southern Methodist,AAC,17,473,61,136,38,67,23,69,34,42,10,58,68,23,14,6,21,26,179
1842,Wesley Iwundu,SO,2014-15,F,Kansas State,Big 12,31,780,63,156,57,137,6,19,47,79,34,74,108,61,23,20,62,65,179
1843,Oskar Michelsen,FR,2014-15,F,Davidson,A-10,32,570,60,156,19,40,41,116,18,26,12,48,60,27,10,5,16,47,179
1844,Michael Milligan,FR,2014-15,F,Central Arkansas,Southland,25,590,62,159,41,92,21,67,34,51,23,58,81,36,36,1,50,68,179
1845,Peter Moller,FR,2014-15,G,Liberty,Big South,25,630,67,159,46,94,21,65,24,35,7,51,58,31,11,0,45,21,179
1846,Alonzo Nelson-Ododa,JR,2014-15,F,Richmond,A-10,27,625,57,126,47,89,10,37,55,68,29,108,137,30,16,45,31,57,179
1847,Brandon Perry,SO,2014-15,F-C,San Diego,WCC,29,382,64,125,64,125,0,0,51,93,50,48,98,7,6,7,32,72,179
1848,Atif Russell,JR,2014-15,G,Pepperdine,WCC,32,619,62,154,48,110,14,44,41,54,24,70,94,29,17,4,22,57,179
1849,James White,JR,2014-15,F,Arkansas-Little Rock,Sun Belt,15,407,67,148,66,147,1,1,44,61,35,64,99,13,8,25,30,45,179
1850,Marvin Williams,SR,2014-15,C,Louisiana-Monroe,Sun Belt,21,474,73,129,72,126,1,3,32,51,36,62,98,10,9,19,35,49,179
1851,Derrick Wilson,SR,2014-15,G,Marquette,Big East,32,1053,68,165,59,126,9,39,34,72,29,97,126,150,38,10,51,65,179
1852,Kaelon Wilson,FR,2014-15,G,Texas-Arlington,Sun Belt,31,608,66,150,49,96,17,54,30,51,32,75,107,17,11,19,30,65,179
1853,Treshawn Bolden,SO,2014-15,F,Jackson State,SWAC,32,658,63,174,63,172,0,2,52,87,32,94,126,28,11,17,75,80,178
1854,Aaron Brennan,FR,2014-15,F,IUPUI,Summit,28,585,71,136,68,128,3,8,33,46,36,52,88,27,21,7,44,72,178
1855,Markel Crawford,FR,2014-15,G,Memphis,AAC,30,682,67,166,42,83,25,83,19,26,16,54,70,54,32,3,36,54,178
1856,Landon Drew,JR,2014-15,G,Cal State Northridge,Big West,31,819,63,179,33,90,30,89,22,32,7,62,69,139,25,1,56,75,178
1857,Amanze Egekeze,FR,2014-15,F,Belmont,OVC,33,661,55,136,28,56,27,80,41,49,32,73,105,22,27,18,26,65,178
1858,Sam Hughes,JR,2014-15,F,North Carolina-Asheville,Big South,29,564,70,161,52,113,18,48,20,29,26,80,106,24,25,4,48,71,178
1859,Todd Johnson,JR,2014-15,G,Northern Kentucky,A-Sun,29,550,60,155,8,18,52,137,6,13,8,49,57,32,29,1,19,47,178
1860,Latrell Love,JR,2014-15,F,Mississippi Valley State,SWAC,30,498,59,137,59,136,0,1,60,85,27,37,64,14,8,5,28,48,178
1861,Chris Martin,JR,2014-15,G,Mount St. Mary's,NEC,24,539,68,189,39,90,29,99,13,16,10,50,60,18,15,0,20,26,178
1862,Jordan Stevens,JR,2014-15,G,Duquesne,A-10,20,375,69,186,47,106,22,80,18,26,6,26,32,53,11,2,36,13,178
1863,Jordan Bell,FR,2014-15,F,Oregon,Pac-12,35,831,83,139,83,139,0,0,11,22,66,148,214,47,28,94,37,95,177
1864,Remond Brown,SO,2014-15,G,Grambling,SWAC,29,814,66,193,65,179,1,14,44,67,27,66,93,39,35,4,58,62,177
1865,Sterling Brown,SO,2014-15,G,Southern Methodist,AAC,34,814,64,122,44,77,20,45,29,37,51,104,155,70,29,8,31,63,177
1866,Jordan Burgess,SO,2014-15,G,Virginia Commonwealth,A-10,35,779,59,162,35,71,24,91,35,65,39,113,152,27,21,17,27,63,177
1867,Mack Foster,JR,2014-15,G,Louisiana-Monroe,Sun Belt,38,676,68,172,45,94,23,78,18,32,18,49,67,34,23,9,30,54,177
1868,Sam Jones,FR,2014-15,F,Pennsylvania,Ivy,28,455,61,151,10,33,51,118,4,7,8,49,57,13,10,5,15,35,177
1869,Luke Meyer,FR,2014-15,F,Central Michigan,MAC,32,508,65,103,58,84,7,19,40,52,24,65,89,14,9,17,24,65,177
1870,Jordan Weethee,JR,2014-15,F,Virginia Military Institute,Southern,30,549,57,160,24,58,33,102,30,41,33,83,116,30,18,2,38,55,177
1871,Mike Aaman,JR,2014-15,F,Wagner,NEC,17,394,65,165,65,165,0,0,46,68,75,83,158,5,10,16,21,40,176
1872,Jake Babic,FR,2014-15,G,Appalachian State,Sun Belt,29,654,58,162,28,59,30,103,30,46,16,56,72,55,8,3,38,46,176
1873,Henry Caruso,SO,2014-15,F,Princeton,Ivy,29,402,50,95,40,72,10,23,66,81,22,62,84,18,6,0,33,43,176
1874,Reveal Chukwujekwu,SO,2014-15,G,Houston Baptist,Southland,28,626,65,143,63,135,2,8,44,57,42,78,120,32,12,8,41,52,176
1875,Marvin Clark,FR,2014-15,F,Michigan State,Big Ten,39,437,64,127,43,65,21,62,27,40,30,56,86,11,9,12,29,67,176
1876,Talbott Denny,JR,2014-15,G,Lipscomb,A-Sun,30,693,58,113,55,103,3,10,57,93,62,82,144,32,17,3,39,88,176
1877,Delvin Dickerson,JR,2014-15,F,Bowling Green State,MAC,31,473,67,171,46,98,21,73,21,39,18,56,74,12,11,5,21,92,176
1878,Xavier Harris,JR,2014-15,F,Fairleigh Dickinson,NEC,28,543,72,146,72,146,0,0,32,56,55,84,139,19,15,30,38,90,176
1879,Trey Kennedy,SO,2014-15,G,Southern Utah,Big Sky,29,644,59,148,45,115,14,33,44,67,6,64,70,58,14,6,44,41,176
1880,Goodluck Okonoboh,FR,2014-15,F-C,Nevada-Las Vegas,MWC,31,827,75,144,75,144,0,0,26,77,57,83,140,21,15,90,29,87,176
1881,Cavon Baker,JR,2014-15,G,Houston,AAC,27,431,54,142,26,57,28,85,39,51,9,31,40,34,18,2,44,45,175
1882,Jordan Cornish,FR,2014-15,G,Nevada-Las Vegas,MWC,32,521,53,125,15,47,38,78,31,39,1,50,51,29,9,4,26,40,175
1883,Nick Daniels,FR,2014-15,G,Oakland,Horizon,28,461,56,123,20,49,36,74,27,38,6,37,43,28,21,2,29,41,175
1884,Cezar Guerrero,JR,2014-15,G,Fresno State,MWC,15,388,54,124,27,60,27,64,40,55,6,41,47,39,17,0,28,42,175
1885,Tre Hale-Edmerson,JR,2014-15,F-C,Cal State Northridge,Big West,33,1044,77,167,66,133,11,34,10,14,20,156,176,83,39,44,62,114,175
1886,Travon Langston,JR,2014-15,G,Southern Utah,Big Sky,29,559,56,140,44,107,12,33,51,76,22,61,83,41,25,2,44,62,175
1887,Jalen Love,JR,2014-15,G,Denver,Summit,25,797,60,152,34,73,26,79,29,34,7,48,55,67,32,1,28,64,175
1888,Dwayne Morgan,FR,2014-15,F,Nevada-Las Vegas,MWC,33,560,66,172,60,155,6,17,37,52,41,57,98,13,19,9,33,90,175
1889,Desi Rodriguez,FR,2014-15,F,Seton Hall,Big East,31,514,62,139,61,127,1,12,50,83,52,87,139,14,25,9,24,71,175
1890,Hunter Ware,FR,2014-15,G,Bryant,NEC,31,524,59,157,34,82,25,75,32,39,12,27,39,33,25,2,35,42,175
1891,Jalen White,SO,2014-15,G,South Carolina State,MEAC,28,516,62,158,48,125,14,33,37,61,9,42,51,58,15,4,49,43,175
1892,C.J. Carr,FR,2014-15,G,Southern Illinois-Edwardsville,OVC,28,495,53,147,32,84,21,63,47,57,10,41,51,61,22,0,41,30,174
1893,Thaddeus Handley,JR,2014-15,F,Arkansas-Pine Bluff,SWAC,31,557,69,147,59,111,10,36,26,51,36,56,92,21,23,4,40,58,174
1894,Troy Harper,FR,2014-15,G,Campbell,Big South,26,444,49,141,24,73,25,68,51,84,4,24,28,22,13,2,34,56,174
1895,Aleksa Jugovic,FR,2014-15,G,Tennessee Tech,OVC,30,538,54,130,23,40,31,90,35,43,4,33,37,60,23,1,35,45,174
1896,Pete Miller,SO,2014-15,F,Princeton,Ivy,30,557,73,134,73,134,0,0,28,66,18,56,74,36,14,35,43,68,174
1897,Chris Obekpa,JR,2014-15,C,St. John's (NY),Big East,30,819,66,143,66,142,0,1,42,81,72,137,209,16,30,94,34,97,174
1898,Justin Raffington,SR,2014-15,C,Florida Atlantic,CUSA,19,564,67,155,62,132,5,23,35,61,46,99,145,18,7,17,46,46,174
1899,Khaliq Spicer,JR,2014-15,F-C,Kent State,MAC,35,792,68,132,68,132,0,0,38,76,81,128,209,11,13,53,30,78,174
1900,Amar Stukes,FR,2014-15,G,La Salle,A-10,33,736,64,143,63,130,1,13,45,70,12,33,45,42,29,0,40,57,174
1901,Malik Gill,JR,2014-15,G,Dartmouth,Ivy,29,537,51,124,33,66,18,58,53,70,11,51,62,93,43,2,56,55,173
1902,Quinton Marshall,JR,2014-15,G,Citadel,Southern,29,729,59,144,51,122,8,22,47,70,32,61,93,35,14,11,46,76,173
1903,Omar Sherman,FR,2014-15,F,Miami (FL),ACC,36,593,67,156,43,77,24,79,15,23,22,60,82,18,8,20,12,59,173
1904,Reid Travis,FR,2014-15,F,Stanford,Pac-12,28,646,67,137,67,137,0,0,39,85,62,94,156,12,24,7,27,60,173
1905,Eric Weary,JR,2014-15,G,Houston,AAC,31,558,59,182,27,52,32,130,23,32,34,76,110,17,16,12,28,39,173
1906,Darrion Allen,SO,2014-15,G,Longwood,Big South,33,686,58,158,42,103,16,55,40,54,31,41,72,30,24,14,35,63,172
1907,Jamie Batish,JR,2014-15,G,Western Illinois,Summit,27,683,59,137,14,29,45,108,9,11,5,47,52,17,6,2,9,44,172
1908,Chris Bolden,JR,2014-15,G,Georgia Tech,ACC,25,532,66,161,36,69,30,92,10,13,2,43,45,25,17,3,26,49,172
1909,Jermaine Crumpton,FR,2014-15,F,Canisius,MAAC,24,422,59,146,42,93,17,53,37,52,15,37,52,12,8,5,21,53,172
1910,Darrell Davis,FR,2014-15,G,Dayton,A-10,36,673,54,141,7,37,47,104,17,23,3,56,59,23,14,3,25,55,172
1911,De'Andre Davis,FR,2014-15,G,Grand Canyon,WAC,30,534,64,123,61,105,3,18,41,62,25,45,70,56,23,4,38,67,172
1912,Jay Johnson,JR,2014-15,F,Marshall,CUSA,32,508,61,179,31,68,30,111,20,45,37,80,117,18,14,9,34,72,172
1913,Steven Kaspar,SR,2014-15,G,Bucknell,Patriot,34,757,48,110,36,77,12,33,64,90,13,80,93,121,33,12,48,81,172
1914,Connor Lammert,JR,2014-15,F,Texas,Big 12,34,750,59,148,33,60,26,88,28,44,43,139,182,43,16,15,29,65,172
1915,Caleb Martin,FR,2014-15,F,North Carolina State,ACC,36,598,53,149,28,67,25,82,41,59,26,77,103,26,11,12,24,40,172
1916,Dusan Perovic,FR,2014-15,F-C,Binghamton,AEC,15,378,65,147,41,94,24,53,18,30,6,43,49,6,8,2,22,40,172
1917,Jared Sam,FR,2014-15,F,Southern,SWAC,33,686,59,108,59,106,0,2,54,85,62,115,177,11,34,24,30,82,172
1918,Ehab Amin,FR,2014-15,G,Texas A&amp;M-Corpus Christi,Southland,33,496,56,131,46,79,10,52,49,71,14,66,80,27,35,5,40,71,171
1919,Doug Brooks,SO,2014-15,G,Virginia Commonwealth,A-10,33,499,61,145,30,69,31,76,18,29,10,57,67,21,39,3,28,77,171
1920,Walter Foster,SO,2014-15,F-C,Towson,CAA,30,749,74,166,74,166,0,0,23,56,66,102,168,20,11,29,38,84,171
1921,Traevon Jackson,SR,2014-15,G,Wisconsin,Big Ten,21,506,60,139,49,100,11,39,40,47,4,31,35,54,19,3,32,27,171
1922,Sam Logwood,FR,2014-15,G-F,New Mexico,MWC,28,572,57,146,40,90,17,56,40,55,24,52,76,31,9,3,29,46,171
1923,Cody McDavis,JR,2014-15,F,Northern Colorado,Big Sky,29,516,71,151,70,148,1,3,28,40,21,57,78,8,8,3,23,65,171
1924,Ben Millaud-Meunier,JR,2014-15,G,Saint Francis (PA),NEC,31,481,52,130,16,26,36,104,31,39,7,47,54,27,10,2,26,22,171
1925,Jacorey Williams,JR,2014-15,F,Arkansas,SEC,36,582,73,179,73,179,0,0,25,59,32,69,101,39,24,15,33,64,171
1926,Edward Alade,SO,2014-15,F-C,Navy,Patriot,32,608,73,124,73,124,0,0,24,38,37,72,109,27,4,16,34,70,170
1927,Mohamed Conde,SR,2014-15,F,Western Illinois,Summit,27,748,68,138,68,138,0,0,34,57,65,98,163,7,25,10,33,75,170
1928,Tyler Davis,JR,2014-15,G,Alabama A&amp;M,SWAC,29,758,55,151,23,53,32,98,28,42,18,34,52,43,27,1,53,54,170
1929,Dylan Poston,JR,2014-15,G,Gardner-Webb,Big South,35,472,55,149,6,20,49,129,11,15,11,38,49,17,14,4,18,46,170
1930,Robert Sampson,SR,2014-15,F,Georgia Tech,ACC,31,664,63,160,51,108,12,52,32,59,66,134,200,17,19,25,40,82,170
1931,Jesse Chuku,JR,2014-15,F,Lehigh,Patriot,30,602,64,148,36,69,28,79,13,28,30,76,106,16,10,23,27,67,169
1932,Mikael Hopkins,SR,2014-15,F,Georgetown,Big East,33,733,53,121,53,121,0,0,63,101,75,116,191,42,33,52,63,110,169
1933,Will Miller,SO,2014-15,F,Mount St. Mary's,NEC,30,542,53,139,5,18,48,121,15,21,8,26,34,16,13,4,11,26,169
1934,Glenn Sanabria,FR,2014-15,G,St. Francis (NY),NEC,28,633,49,117,18,48,31,69,40,60,23,31,54,58,20,4,31,49,169
1935,Jaren Sina,FR,2014-15,G,Seton Hall,Big East,24,772,51,158,11,33,40,125,27,34,21,39,60,55,10,0,33,27,169
1936,Felix Van Hofe,SO,2014-15,F,Eastern Washington,Big Sky,33,511,58,141,16,39,42,102,11,19,11,36,47,20,9,10,17,43,169
1937,Wheeler Baker,FR,2014-15,G,Albany (NY),AEC,30,417,56,143,21,50,35,93,21,29,5,37,42,11,10,3,27,39,168
1938,Boris Bojanovsky,JR,2014-15,C,Florida State,ACC,33,540,57,99,57,99,0,0,54,80,36,77,113,18,22,44,27,62,168
1939,Anthony D'Orazio,SR,2014-15,G,Rider,MAAC,33,775,62,158,42,95,20,63,24,40,21,76,97,70,39,6,41,63,168
1940,Mike Davis,JR,2014-15,G,Alcorn State,SWAC,26,632,60,151,49,122,11,29,37,47,22,35,57,42,29,1,37,39,168
1941,Geoffrey Groselle,JR,2014-15,C,Creighton,Big East,31,382,72,111,72,111,0,0,24,36,33,43,76,9,5,18,28,52,168
1942,Greg Lewis,JR,2014-15,F-C,Rutgers,Big Ten,32,760,59,125,59,125,0,0,50,78,46,97,143,29,20,29,44,94,168
1943,JoJo McGlaston,SO,2014-15,G,Utah State,MWC,30,654,51,160,30,97,21,63,45,73,11,79,90,58,12,18,40,49,168
1944,Joey McLean,FR,2014-15,G,James Madison,CAA,26,558,51,129,22,40,29,89,37,48,10,42,52,50,35,0,38,63,168
1945,Hanner Mosquera-Perea,JR,2014-15,F,Indiana,Big Ten,26,505,63,106,63,106,0,0,42,73,37,74,111,6,6,33,28,61,168
1946,Ricmonds Vilde,GR,2014-15,C-F,Houston Baptist,Southland,28,441,68,122,64,111,4,11,28,46,46,102,148,16,8,19,53,61,168
1947,Nouhoum Bocoum,JR,2014-15,C,Arkansas State,Sun Belt,28,434,63,142,62,139,1,3,40,59,47,75,122,3,5,12,29,48,167
1948,Jacob Schulte,FR,2014-15,F,South Carolina Upstate,A-Sun,36,644,70,109,70,108,0,1,27,61,61,61,122,12,10,38,24,70,167
1949,Dylan Sherwood,JR,2014-15,F,North Carolina-Wilmington,CAA,29,456,61,143,24,47,37,96,8,10,29,44,73,1,15,2,17,38,167
1950,Tarique Thompson,SO,2014-15,F,High Point,Big South,33,556,63,136,62,133,1,3,40,54,34,53,87,28,14,9,20,50,167
1951,Jamari Traylor,JR,2014-15,F,Kansas,Big 12,35,714,67,138,67,138,0,0,33,55,54,76,130,33,28,37,53,79,167
1952,C.J. Turman,FR,2014-15,C,Florida Atlantic,CUSA,29,526,68,118,68,118,0,0,31,56,24,71,95,6,6,18,40,87,167
1953,P.J. Boutte,JR,2014-15,G,IUPUI,Summit,29,663,51,167,29,99,22,68,42,54,22,48,70,83,29,0,60,50,166
1954,Nyles Evans,SR,2014-15,G,Akron,MAC,35,674,59,157,27,62,32,95,16,23,16,72,88,57,33,0,31,64,166
1955,Igor Hadziomerovic,SR,2014-15,G,Boise State,MWC,33,785,56,123,41,87,15,36,39,58,26,76,102,88,16,6,54,53,166
1956,Tyler Russell,SR,2014-15,G,Houston Baptist,Southland,28,546,59,160,45,111,14,49,34,40,11,36,47,33,22,4,43,55,166
1957,Steven Burrough,FR,2014-15,C,North Carolina A&amp;T,MEAC,32,615,59,99,59,99,0,0,47,70,37,62,99,11,9,54,33,91,165
1958,Dallas Cameron,SO,2014-15,G,Stephen F. Austin,Southland,34,649,47,115,26,61,21,54,50,69,10,37,47,49,19,5,44,52,165
1959,Jordon Granger,JR,2014-15,F,Auburn,SEC,34,786,60,129,33,56,27,73,18,31,38,79,117,35,22,22,42,85,165
1960,Josh Ibarra,FR,2014-15,C,Houston Baptist,Southland,27,448,73,115,73,115,0,0,19,35,60,115,175,16,11,55,32,80,165
1961,Nigel Johnson,SO,2014-15,G,Kansas State,Big 12,32,572,51,128,31,69,20,59,43,64,11,41,52,55,32,0,32,34,165
1962,Luka Kamber,SO,2014-15,F,Nicholls State,Southland,29,539,56,144,15,34,41,110,12,22,12,48,60,26,14,5,35,50,165
1963,Nate Kratch,SO,2014-15,F,Santa Clara,WCC,32,673,64,121,63,112,1,9,36,66,71,75,146,11,16,21,31,112,165
1964,Alex Robinson,FR,2014-15,G,Texas A&amp;M,SEC,32,600,65,155,52,119,13,36,22,37,15,60,75,84,15,2,53,45,165
1965,Marvin Singleton,SR,2014-15,F,Northern Iowa,MVC,35,874,67,127,65,113,2,14,29,45,72,100,172,23,10,5,33,60,165
1966,Paul White,FR,2014-15,F,Georgetown,Big East,33,607,59,146,36,85,23,61,24,34,13,79,92,41,14,19,30,62,165
1967,Leron Black,FR,2014-15,F,Illinois,Big Ten,33,487,67,141,67,138,0,3,30,44,42,99,141,4,11,6,28,89,164
1968,Brandon Conley,JR,2014-15,F,Oral Roberts,Summit,34,622,63,113,63,113,0,0,38,59,45,76,121,18,14,30,41,108,164
1969,Devonte' Graham,FR,2014-15,G,Kansas,Big 12,29,517,46,117,29,77,17,40,55,76,8,35,43,61,25,0,33,44,164
1970,Jaleel Hogan,FR,2014-15,F,Detroit Mercy,Horizon,33,481,62,100,62,99,0,1,40,79,35,47,82,8,9,8,25,92,164
1971,Dakota Mathias,FR,2014-15,G,Purdue,Big Ten,34,667,52,159,14,41,38,118,22,31,3,69,72,47,17,3,26,58,164
1972,Javon McKay,SR,2014-15,G-F,Tennessee Tech,OVC,29,580,58,119,50,91,8,28,40,54,34,51,85,35,19,13,38,49,164
1973,Bernard Morena,SO,2014-15,F,Kennesaw State,A-Sun,31,500,60,124,56,114,4,10,40,69,47,75,122,11,9,21,36,82,164
1974,Austin Stewart,JR,2014-15,G,Central Michigan,MAC,32,479,52,102,36,72,16,30,44,65,45,65,110,13,25,0,30,43,164
1975,Zach Thomas,FR,2014-15,F,Bucknell,Patriot,22,356,45,98,27,63,18,35,56,74,21,63,84,19,8,6,29,36,164
1976,Anthony Clemmons,JR,2014-15,G,Iowa,Big Ten,34,677,48,126,26,67,22,59,45,60,12,54,66,64,24,1,38,53,163
1977,Allerik Freeman,FR,2014-15,G,Baylor,Big 12,34,581,55,129,35,67,20,62,33,47,16,48,64,34,10,0,39,29,163
1978,Donovan Gilmore,FR,2014-15,F,College of Charleston,CAA,32,509,67,124,66,120,1,4,28,43,42,91,133,2,14,9,30,65,163
1979,Devin Harris,FR,2014-15,G,East Tennessee State,Southern,27,587,52,130,47,115,5,15,54,81,52,102,154,27,24,5,42,65,163
1980,Jamal Hunter,SR,2014-15,C-F,Jacksonville State,OVC,30,681,68,133,68,133,0,0,27,40,61,100,161,18,17,63,37,100,163
1981,Jaden Jackson,JR,2014-15,G,Utah Valley,WAC,30,537,58,177,34,90,24,87,23,32,6,39,45,41,17,0,22,37,163
1982,Tadric Jackson,FR,2014-15,G,Georgia Tech,ACC,30,451,55,201,39,111,16,90,37,60,16,35,51,28,4,4,17,36,163
1983,Chris Kading,JR,2014-15,F,North Dakota State,Summit,31,806,65,135,55,91,10,44,23,46,52,69,121,12,11,47,12,73,163
1984,JeVon Lyle,JR,2014-15,G,Milwaukee,Horizon,26,601,54,131,32,64,22,67,33,50,14,25,39,30,27,1,34,69,163
1985,Eric Truog,JR,2014-15,C,Marist,MAAC,31,772,69,136,60,108,9,28,16,38,53,120,173,47,24,21,41,98,163
1986,Kiel Turpin,SR,2014-15,C,Florida State,ACC,33,411,71,127,71,127,0,0,21,35,36,40,76,3,7,23,31,89,163
1987,BeeJay Anya,SO,2014-15,F,North Carolina State,ACC,36,698,64,105,64,105,0,0,34,61,57,98,155,8,4,91,40,97,162
1988,Trevor Berkeley,SR,2014-15,F,Drake,MVC,31,624,62,112,50,87,12,25,26,36,26,60,86,20,11,17,36,71,162
1989,Drew Charles,SO,2014-15,G,Texas-Arlington,Sun Belt,23,460,53,126,30,70,23,56,33,41,12,42,54,34,13,0,26,50,162
1990,Alex Gavrilovic,SR,2014-15,C,Towson,CAA,30,520,55,140,33,74,22,66,30,37,44,76,120,11,7,6,28,55,162
1991,Chad Lang,SR,2014-15,C,Lipscomb,A-Sun,31,372,66,117,66,117,0,0,30,55,42,65,107,1,5,22,28,79,162
1992,Khufu Najee,SR,2014-15,G,IUPUI,Summit,22,520,64,144,58,122,6,22,28,35,19,49,68,26,16,4,37,45,162
1993,Eric Robertson,JR,2014-15,F,South Dakota,Summit,32,612,59,135,54,120,5,15,39,56,37,67,104,7,14,23,17,96,162
1994,Briante Weber,SR,2014-15,G,Virginia Commonwealth,A-10,20,529,55,137,43,108,12,29,40,54,14,59,73,85,78,4,34,39,162
1995,Colton Weisbrod,FR,2014-15,G-F,New Orleans,Southland,23,428,65,124,65,122,0,2,32,57,32,40,72,10,14,5,18,54,162
1996,Dallas Ennema,SO,2014-15,F,Albany (NY),AEC,33,632,54,139,26,53,28,86,25,37,13,53,66,18,8,3,17,43,161
1997,Robert Heyer,SR,2014-15,G-F,Boise State,MWC,34,704,54,103,32,50,22,53,31,36,43,64,107,24,14,7,24,63,161
1998,Riley Norris,FR,2014-15,G-F,Alabama,SEC,34,712,55,145,30,71,25,74,26,43,40,102,142,22,21,7,31,79,161
1999,Frank Snow,SR,2014-15,C,Southern,SWAC,31,504,57,121,57,121,0,0,47,82,49,62,111,5,7,39,28,69,161
2000,Frank Booker,SO,2014-15,G,Oklahoma,Big 12,32,459,48,146,12,27,36,119,28,34,10,34,44,18,16,5,23,45,160
2001,Duke Ethridge,JR,2014-15,F,Chattanooga,Southern,30,377,55,110,46,78,9,32,41,62,32,64,96,8,12,21,33,52,160
2002,Justin Hammonds,SR,2014-15,F,Air Force,MWC,25,524,58,106,53,94,5,12,39,64,22,71,93,49,20,6,43,75,160
2003,Yante Maten,FR,2014-15,F-C,Georgia,SEC,32,583,57,137,57,136,0,1,46,71,56,80,136,8,10,45,30,67,160
2004,Freddie Wilson,SR,2014-15,G,Drexel,CAA,30,636,53,160,23,61,30,99,24,39,4,41,45,45,18,2,36,46,160
2005,Arturs Bremers,JR,2014-15,G,North Carolina A&amp;T,MEAC,26,645,48,144,2,11,46,133,17,19,10,36,46,28,11,1,32,30,159
2006,Devonte Hall,FR,2014-15,G,Northwestern State,Southland,32,641,61,177,54,129,7,48,30,43,18,48,66,56,31,4,37,76,159
2007,Travis Hammonds,SO,2014-15,G,Long Beach State,Big West,25,423,53,113,35,67,18,46,35,50,16,51,67,12,15,4,28,54,159
2008,Stephon Jelks,FR,2014-15,F,Mercer,Southern,31,397,61,116,49,89,12,27,25,37,39,62,101,14,14,6,16,34,159
2009,Javaris Jenkins,SO,2014-15,G-F,Savannah State,MEAC,23,468,55,163,28,76,27,87,22,35,23,55,78,13,15,14,21,44,159
2010,Fabijan Krslovic,FR,2014-15,F,Montana,Big Sky,33,829,62,119,62,119,0,0,35,64,58,98,156,35,36,19,33,83,159
2011,Aleksa Nikolic,FR,2014-15,G,Marshall,CUSA,32,833,63,225,50,161,13,64,20,28,21,110,131,111,34,4,95,63,159
2012,Malik Pope,FR,2014-15,F,San Diego State,MWC,31,459,56,123,36,74,20,49,27,40,25,59,84,19,8,24,25,30,159
2013,Charles Tucker,FR,2014-15,G,Tennessee State,OVC,31,668,43,107,29,65,14,42,59,74,4,36,40,71,13,0,54,49,159
2014,James Whitaker,FR,2014-15,G,North Carolina A&amp;T,MEAC,32,518,50,155,34,85,16,70,43,56,18,35,53,10,15,8,42,43,159
2015,Marcus Bartley,FR,2014-15,G,Saint Louis,A-10,32,613,52,126,15,40,37,86,17,29,6,47,53,55,12,3,44,82,158
2016,Marcus Bradley,JR,2014-15,F,Idaho State,Big Sky,25,309,68,148,63,122,5,26,17,32,16,33,49,4,4,14,16,56,158
2017,Christopher Hyder,JR,2014-15,G,Southern,SWAC,35,1025,52,125,50,112,2,13,52,73,25,109,134,137,45,1,58,64,158
2018,Mamadou Ndiaye,SO,2014-15,C,California-Irvine,Big West,15,298,64,101,64,100,0,1,30,57,23,54,77,2,4,25,23,46,158
2019,Matt Thomas,SO,2014-15,G,Iowa State,Big 12,32,488,53,144,21,47,32,97,20,28,6,57,63,22,11,2,15,36,158
2020,Gavin Thurman,JR,2014-15,F,Missouri State,MVC,26,455,65,180,50,114,15,66,12,18,9,53,62,20,7,4,25,28,157
2021,Denzell Watts,SO,2014-15,G,Alabama-Birmingham,CUSA,36,659,51,138,33,88,18,50,37,50,5,56,61,68,30,1,42,48,157
2022,James Farr,JR,2014-15,F,Xavier,Big East,37,578,64,150,51,105,13,45,15,32,49,148,197,15,13,29,39,64,156
2023,Neal Monson,SO,2014-15,C,California-Davis,Big West,32,460,62,101,62,101,0,0,32,41,27,81,108,15,11,7,29,50,156
2024,Shaquille Morris,FR,2014-15,F,Wichita State,MVC,33,420,61,112,61,111,0,1,34,53,26,60,86,11,9,26,30,92,156
2025,Donte Pretlow,JR,2014-15,G,Morgan State,MEAC,31,783,58,225,49,176,9,49,31,59,19,60,79,101,34,2,59,56,156
2026,Jermaine Sanders,SR,2014-15,F,Cincinnati,AAC,34,711,55,144,31,55,24,89,22,39,32,70,102,29,16,3,19,37,156
2027,Quincy Smith,JR,2014-15,G,Hawaii,Big West,35,576,52,120,46,95,6,25,46,82,19,74,93,30,43,3,41,60,156
2028,Tom Vodanovich,SO,2014-15,F,James Madison,CAA,29,662,59,109,57,93,2,16,36,60,27,89,116,13,16,12,37,74,156
2029,Aaron Adeoye,SR,2014-15,F,Southeast Missouri State,OVC,30,604,59,131,56,118,3,13,34,49,39,85,124,25,17,18,43,83,155
2030,Denzel Brito,SR,2014-15,G,Loyola (MD),Patriot,30,771,51,158,34,95,17,63,36,49,8,80,88,69,23,1,49,35,155
2031,Clay Byrd,SO,2014-15,G,North Carolina-Greensboro,Southern,28,639,48,149,4,12,44,137,15,17,2,21,23,25,8,3,18,44,155
2032,Kyle Dranginis,JR,2014-15,G,Gonzaga,WCC,38,654,50,107,34,60,16,47,39,49,34,64,98,63,23,15,32,74,155
2033,Cameron Harvey,SO,2014-15,G,Stetson,A-Sun,31,586,53,170,18,64,35,106,14,18,5,33,38,15,4,0,24,41,155
2034,Jeremiah Ingram,JR,2014-15,G,North Carolina Central,MEAC,33,519,46,85,44,76,2,9,61,99,41,52,93,17,20,11,45,83,155
2035,Joshua Meier,FR,2014-15,F,Chicago State,WAC,31,642,59,159,58,158,1,1,36,58,66,58,124,19,19,17,58,77,155
2036,Dwayne Polee,SR,2014-15,F,San Diego State,MWC,20,410,49,139,29,71,20,68,37,58,13,39,52,16,27,6,20,27,155
2037,Victor Robbins,JR,2014-15,G-F,Oregon State,Pac-12,15,325,53,115,43,82,10,33,39,55,20,33,53,9,14,2,17,23,155
2038,Jeff Roberson,FR,2014-15,F,Vanderbilt,SEC,33,637,50,103,35,70,15,33,40,64,32,70,102,37,13,10,48,86,155
2039,Ray Rodriguez,SO,2014-15,G,Florida International,CUSA,32,675,48,129,11,26,37,103,22,32,8,48,56,50,12,1,41,41,155
2040,Bobby Sharp,SR,2014-15,G,Portland,WCC,31,484,51,168,9,33,42,135,11,13,1,35,36,22,13,1,9,46,155
2041,Max Bielfeldt,SR,2014-15,F,Michigan,Big Ten,30,434,62,129,54,99,8,30,22,32,43,65,108,14,8,7,20,41,154
2042,Omar Calhoun,JR,2014-15,G,Connecticut,AAC,28,484,54,143,28,67,26,76,20,26,12,32,44,20,14,4,26,21,154
2043,Angelo Chol,JR,2014-15,F,San Diego State,MWC,35,478,64,116,64,116,0,0,26,53,45,65,110,6,8,18,35,65,154
2044,Collin Hartman,SO,2014-15,F,Indiana,Big Ten,32,631,51,102,22,41,29,61,23,35,46,52,98,26,16,19,22,70,154
2045,Jito Kok,JR,2014-15,F-C,San Diego,WCC,30,696,55,129,55,129,0,0,44,72,33,72,105,11,12,75,37,75,154
2046,Steve Rogers,FR,2014-15,G,Alabama State,SWAC,29,423,47,113,17,47,30,66,30,37,13,25,38,29,7,1,29,47,154
2047,Desmond Simmons,SR,2014-15,F,Saint Mary's (CA),WCC,31,862,48,138,19,55,29,83,29,39,63,134,197,44,30,7,33,83,154
2048,Jourdan Stickler,JR,2014-15,G-F,Houston Baptist,Southland,26,375,51,125,31,68,20,57,32,47,23,35,58,18,12,0,22,31,154
2049,Grayson Allen,FR,2014-15,G,Duke,ACC,35,322,45,106,27,54,18,52,45,53,9,26,35,14,10,5,15,42,153
2050,Marcellous Bell,JR,2014-15,G,Jacksonville,A-Sun,25,362,46,124,14,34,32,90,29,33,5,21,26,18,16,0,5,20,153
2051,James Ford,JR,2014-15,G,Quinnipiac,MAAC,29,517,46,140,15,50,31,90,30,37,20,53,73,32,10,3,24,58,153
2052,Maurius Hill,SO,2014-15,F,Arkansas-Little Rock,Sun Belt,25,421,59,145,51,121,8,24,27,43,37,72,109,23,10,4,34,36,153
2053,Austin Lewis,JR,2014-15,F,McNeese State,Southland,29,548,63,111,63,111,0,0,27,43,54,71,125,4,4,64,21,74,153
2054,Maliik Love,SR,2014-15,G,Cal Poly,Big West,29,819,63,144,60,135,3,9,24,47,48,58,106,79,22,6,50,48,153
2055,Juwan Major,FR,2014-15,G,Southern Utah,Big Sky,29,620,59,111,56,97,3,14,32,54,12,42,54,39,12,5,50,73,153
2056,Cheikh Sane,SR,2014-15,F,Marshall,CUSA,32,574,52,124,51,118,1,6,48,80,58,83,141,24,17,16,45,93,153
2057,T.J. Shipes,JR,2014-15,F,Georgia State,Sun Belt,33,688,62,108,62,108,0,0,29,59,56,74,130,7,22,17,23,102,153
2058,Matt Shrigley,SO,2014-15,F,San Diego State,MWC,30,632,53,156,12,30,41,126,6,6,6,43,49,31,24,9,26,38,153
2059,Shaun Stewart,JR,2014-15,G,Youngstown State,Horizon,32,552,52,152,21,49,31,103,18,26,14,51,65,36,10,4,21,40,153
2060,Mario Blessing,SR,2014-15,G,South Carolina Upstate,A-Sun,36,968,55,150,19,35,36,115,6,9,26,55,81,93,34,0,37,72,152
2061,Dustin Clarke,JR,2014-15,G,Appalachian State,Sun Belt,29,571,54,166,28,71,26,95,18,25,33,72,105,30,15,2,20,27,152
2062,Ryan Kemrite,FR,2014-15,G-F,Liberty,Big South,32,487,46,107,10,25,36,82,24,44,12,37,49,13,18,0,19,55,152
2063,Malik Martin,FR,2014-15,F,Southern California,Pac-12,29,519,65,124,59,102,6,22,16,44,39,66,105,13,12,22,44,64,152
2064,Aaron Simpson,JR,2014-15,G,DePaul,Big East,32,544,50,131,23,53,27,78,25,37,17,48,65,36,13,2,31,54,152
2065,Tamarcio Wilson,JR,2014-15,G,Alcorn State,SWAC,27,480,57,134,46,97,11,37,27,45,10,42,52,24,13,3,31,28,152
2066,Jubril Adekoya,SO,2014-15,G,Valparaiso,Horizon,32,633,56,117,55,114,1,3,38,68,50,84,134,21,17,8,29,73,151
2067,Kevin Bleeker,JR,2014-15,C,Canisius,MAAC,33,581,54,122,41,76,13,46,30,40,45,86,131,32,14,30,41,75,151
2068,T.J. Curry,SR,2014-15,G,Marist,MAAC,17,500,48,119,15,33,33,86,22,28,17,51,68,26,24,0,27,27,151
2069,Ruben Guerrero,FR,2014-15,C-F,South Florida,AAC,28,678,63,133,63,133,0,0,25,49,68,61,129,7,8,43,34,49,151
2070,Madison Jones,JR,2014-15,G,Wake Forest,ACC,32,673,50,117,50,114,0,3,51,86,10,65,75,97,34,7,62,65,151
2071,Sammy Mojica,FR,2014-15,G,Drexel,CAA,24,593,57,145,33,80,24,65,13,28,29,41,70,41,23,3,26,44,151
2072,Cortez Conners,JR,2014-15,G,Cal State Bakersfield,WAC,32,498,52,141,24,62,28,79,18,19,12,35,47,26,20,1,25,50,150
2073,Sheldon Jeter,SO,2014-15,F,Pittsburgh,ACC,32,458,58,122,48,95,10,27,24,39,30,49,79,15,11,10,19,53,150
2074,Jestin Lewis,JR,2014-15,G,Mercer,Southern,35,473,47,126,12,34,35,92,21,32,4,57,61,22,27,0,18,26,150
2075,Demetris Morant,SO,2014-15,F,Florida Gulf Coast,A-Sun,33,623,64,112,64,112,0,0,22,44,71,75,146,7,7,42,27,91,150
2076,Chris Reyes,SO,2014-15,F,Utah,Pac-12,35,549,58,125,56,122,2,3,32,59,41,87,128,16,9,22,25,48,150
2077,Ben Richardson,FR,2014-15,G,Loyola (IL),MVC,36,720,51,134,21,49,30,85,18,22,9,56,65,55,33,7,29,62,150
2078,Matt Scott,FR,2014-15,G,Niagara,MAAC,30,510,41,126,25,76,16,50,52,69,30,51,81,23,20,3,44,49,150
2079,Deshaun Thrower,FR,2014-15,G,Stony Brook,AEC,35,668,49,163,30,102,19,61,33,44,14,44,58,45,17,0,32,53,150
2080,Jason Todd,FR,2014-15,G-F,Portland,WCC,31,722,56,118,34,68,22,50,16,28,29,82,111,50,15,3,27,34,150
2081,Larry Toomey,JR,2014-15,F,Army,Patriot,30,651,54,133,30,62,24,71,18,35,38,87,125,38,21,8,32,79,150
2082,Jacobi Boykins,FR,2014-15,G,Louisiana Tech,CUSA,36,383,51,113,19,32,32,81,15,25,9,27,36,8,22,5,19,49,149
2083,Tony Dobbinson,JR,2014-15,G,Northwestern State,Southland,27,365,52,139,19,48,33,91,12,18,12,26,38,19,8,2,36,22,149
2084,Tre Drye,SR,2014-15,F,Tulane,AAC,31,750,51,114,49,103,2,11,45,80,61,91,152,23,20,6,43,81,149
2085,Daeshon Francis,FR,2014-15,G,Green Bay,Horizon,33,447,54,87,53,85,1,2,40,62,35,35,70,25,11,9,20,49,149
2086,Justin Johnson,FR,2014-15,F,Western Kentucky,CUSA,31,482,60,119,60,116,0,3,29,67,46,80,126,22,13,14,18,48,149
2087,Justin Jordan,FR,2014-15,G,Milwaukee,Horizon,30,642,52,138,30,70,22,68,23,36,8,57,65,33,9,2,34,41,149
2088,D.J. McCall,FR,2014-15,G,IUPUI,Summit,31,664,52,124,46,105,6,19,39,61,31,58,89,38,19,1,55,49,149
2089,Chris McCullough,FR,2014-15,F,Syracuse,ACC,16,450,54,113,53,112,1,1,40,71,36,74,110,18,27,33,35,41,149
2090,Ahmaad Rorie,FR,2014-15,G,Oregon,Pac-12,36,675,52,125,36,77,16,48,29,39,14,65,79,66,6,4,36,45,149
2091,Rasheed Sulaimon,JR,2014-15,G,Duke,ACC,20,386,52,126,29,69,23,57,22,33,4,36,40,35,19,1,26,39,149
2092,Brandon Alston,FR,2014-15,F,Lehigh,Patriot,30,474,46,121,32,82,14,39,42,57,12,32,44,20,6,1,39,45,148
2093,Justin Colvin,JR,2014-15,G,Alabama A&amp;M,SWAC,28,502,48,138,23,53,25,85,27,43,12,37,49,31,15,3,27,49,148
2094,Aaron Cosby,JR,2014-15,G,Illinois,Big Ten,19,480,46,157,14,54,32,103,24,30,6,63,69,32,5,0,25,27,148
2095,Tristian Curtis,JR,2014-15,F,Coastal Carolina,Big South,33,713,57,106,57,106,0,0,34,66,82,121,203,6,8,24,28,72,148
2096,Corey Edwards,SR,2014-15,G,George Mason,A-10,30,733,46,130,20,51,26,79,30,40,3,49,52,76,46,1,47,71,148
2097,Greg Kelley,SR,2014-15,F,Yale,Ivy,32,418,52,126,27,52,25,74,19,24,28,52,80,15,9,12,17,69,148
2098,Demontez Loman,JR,2014-15,F,Tennessee State,OVC,31,804,59,132,59,131,0,1,30,60,49,127,176,21,21,39,40,100,148
2099,Treg Setty,JR,2014-15,F,Ohio,MAC,29,512,56,121,45,88,11,33,25,41,31,65,96,27,15,7,35,72,148
2100,Jon Severe,SO,2014-15,G,Fordham,A-10,22,416,52,151,38,93,14,58,30,37,18,39,57,32,19,5,44,42,148
2101,Corey Spence,SR,2014-15,G,Northern Colorado,Big Sky,30,626,49,128,37,86,12,42,38,45,16,45,61,63,21,0,35,44,148
2102,Jamal Williams,FR,2014-15,G,Sam Houston State,Southland,33,438,52,108,45,87,7,21,37,52,16,51,67,33,16,7,37,42,148
2103,Devon Baulkman,JR,2014-15,G,Tennessee,SEC,31,457,45,118,19,50,26,68,31,39,28,44,72,19,19,3,24,35,147
2104,Justin Coleman,FR,2014-15,G,Alabama,SEC,34,614,41,158,15,49,26,109,39,52,8,28,36,48,19,0,37,33,147
2105,Zach Fong,SO,2014-15,G,Navy,Patriot,31,422,48,130,14,30,34,100,17,22,1,20,21,20,7,1,22,25,147
2106,Loomis Gerring,JR,2014-15,F,Missouri State,MVC,31,593,53,149,50,131,3,18,38,55,47,65,112,18,17,6,36,64,147
2107,Race Parsons,SO,2014-15,G,Southern Utah,Big Sky,27,416,50,132,22,45,28,87,19,24,18,41,59,19,8,2,19,43,147
2108,Monty Boykins,SO,2014-15,G,Lafayette,Patriot,31,391,50,131,25,70,25,61,21,36,7,38,45,25,10,2,34,30,146
2109,Trey Davis,JR,2014-15,F,Richmond,A-10,35,1071,59,123,53,103,6,20,22,53,32,137,169,81,43,9,51,93,146
2110,Marcus Freeman,JR,2014-15,F,Coastal Carolina,Big South,27,376,57,108,57,108,0,0,32,55,64,89,153,8,13,25,17,52,146
2111,Ronnel Jordan,JR,2014-15,G-F,New Hampshire,AEC,30,439,56,138,39,88,17,50,17,27,11,57,68,15,4,0,22,34,146
2112,Arkeem Joseph,JR,2014-15,C,Tennessee-Martin,OVC,30,466,69,132,69,132,0,0,8,27,42,42,84,6,1,4,31,52,146
2113,Dominique Major,SR,2014-15,G,Saint Francis (PA),NEC,31,559,44,148,4,18,40,130,18,26,4,16,20,19,16,1,14,32,146
2114,Kanayo Obi-Rapu,FR,2014-15,G,Longwood,Big South,33,532,51,133,22,46,29,87,15,25,7,61,68,23,18,4,39,72,146
2115,Everett Osborne,JR,2014-15,G,Texas-Pan American,WAC,31,491,48,140,36,99,12,41,38,50,11,32,43,21,9,6,35,38,146
2116,Kelvin Penn,SR,2014-15,F,Florida Atlantic,CUSA,29,781,63,114,63,114,0,0,20,38,81,101,182,25,19,41,35,95,146
2117,Jodan Price,SO,2014-15,G-F,Eastern Michigan,MAC,34,533,50,181,13,46,37,135,9,13,11,55,66,14,16,19,20,37,146
2118,Jerome Segura,FR,2014-15,G,Fairfield,MAAC,30,623,59,162,46,116,13,46,15,31,5,30,35,64,15,2,60,48,146
2119,Quentin Snider,FR,2014-15,G,Louisville,ACC,36,589,53,152,34,85,19,67,21,38,9,49,58,47,11,1,29,43,146
2120,Jordan Strawberry,FR,2014-15,G,Mercer,Southern,34,501,59,149,45,111,14,38,14,18,11,29,40,70,15,0,42,47,146
2121,Jake White,JR,2014-15,F,Nebraska-Omaha,Summit,20,407,51,128,47,106,4,22,40,59,49,63,112,9,6,7,16,48,146
2122,Bobby Ahearn,FR,2014-15,F,Binghamton,AEC,31,613,61,117,61,117,0,0,23,46,55,71,126,11,17,9,35,88,145
2123,Darius Austin,FR,2014-15,G-F,Missouri-Kansas City,WAC,33,638,58,145,54,133,4,12,25,50,51,88,139,25,22,23,33,76,145
2124,Jamal Branch,SR,2014-15,G,St. John's (NY),Big East,30,673,59,127,49,96,10,31,17,23,16,58,74,71,18,0,29,51,145
2125,Michael Calder,JR,2014-15,G,IPFW,Summit,31,482,46,109,23,56,23,53,30,48,6,58,64,38,11,0,46,41,145
2126,Jeff Coby,SO,2014-15,F,Columbia,Ivy,27,459,49,131,36,88,13,43,34,47,37,53,90,14,6,19,37,61,145
2127,Brandon Graham,SR,2014-15,F,Alabama State,SWAC,29,511,49,117,39,71,10,46,37,58,30,59,89,20,14,23,28,74,145
2128,Andrew Guillory,JR,2014-15,G,Southeastern Louisiana,Southland,18,486,46,101,41,80,5,21,48,67,16,47,63,37,12,1,26,25,145
2129,Kaza Keane,JR,2014-15,G,Cleveland State,Horizon,33,710,54,131,42,87,12,44,25,42,22,42,64,71,32,1,27,59,145
2130,Tyler Livingston,SO,2014-15,F,Massachusetts-Lowell,AEC,29,425,54,152,24,55,30,97,7,9,21,44,65,13,11,6,21,50,145
2131,Xavier  Talton,JR,2014-15,G,Colorado,Pac-12,34,763,45,149,20,70,25,79,30,41,4,54,58,54,20,3,48,68,145
2132,Alex Tiffin,SR,2014-15,F,Sacramento State,Big Sky,33,518,58,120,58,119,0,1,29,40,32,63,95,9,8,9,28,80,145
2133,D'Marques Tyson,FR,2014-15,G,Portland,WCC,25,248,48,113,13,24,35,89,14,17,3,18,21,7,5,1,14,18,145
2134,Chris Walker,SO,2014-15,F,Florida,SEC,31,453,64,119,64,116,0,3,17,44,41,67,108,2,10,36,32,63,145
2135,Peyton Allen,FR,2014-15,G,Texas A&amp;M,SEC,32,452,49,129,19,36,30,93,16,20,5,19,24,15,8,4,18,42,144
2136,Demarcus Bryant,FR,2014-15,G,Savannah State,MEAC,29,464,50,157,13,36,37,121,7,8,8,17,25,10,6,1,30,36,144
2137,Ed Drew,SO,2014-15,F,Presbyterian,Big South,32,587,59,125,58,120,1,5,25,43,44,61,105,13,15,18,28,56,144
2138,Jayrn Johnson,SO,2014-15,G,Prairie View,SWAC,33,401,50,131,40,99,10,32,34,42,7,20,27,15,26,8,18,45,144
2139,Gabe McCray,JR,2014-15,F,South Carolina State,MEAC,32,517,54,137,51,114,3,23,33,62,38,90,128,8,20,2,40,63,144
2140,Vasa Pusica,FR,2014-15,G,San Diego,WCC,31,470,47,122,34,75,13,47,37,49,14,51,65,42,15,3,27,55,144
2141,Sam Singer,SO,2014-15,G,California,Pac-12,33,793,57,131,44,84,13,47,17,35,12,74,86,97,24,5,45,79,144
2142,Brent Wrapp,FR,2014-15,G,Cal State Bakersfield,WAC,33,679,42,89,42,83,0,6,60,86,21,84,105,111,22,2,42,79,144
2143,Coreontae DeBerry,JR,2014-15,C,Cincinnati,AAC,34,360,54,99,54,99,0,0,35,57,25,47,72,3,2,33,24,52,143
2144,Luke Eddy,SO,2014-15,G,Elon,CAA,11,214,51,88,34,54,17,34,24,31,2,24,26,23,13,2,20,21,143
2145,Rayvon Harris,JR,2014-15,G-F,Niagara,MAAC,25,426,46,106,41,89,5,17,46,72,29,52,81,15,7,7,52,52,143
2146,Craig Hinton,SO,2014-15,F,Virginia Military Institute,Southern,28,364,50,125,21,43,29,82,14,21,28,43,71,19,14,10,28,45,143
2147,Jordan Lauf,SO,2014-15,G,Toledo,MAC,33,633,44,93,32,59,12,34,43,64,46,72,118,36,30,4,20,65,143
2148,Kellen McCormick,SO,2014-15,F,Western Michigan,MAC,32,399,50,111,19,33,31,78,12,17,17,30,47,8,5,2,13,44,143
2149,Ryan Richardson,FR,2014-15,G,Weber State,Big Sky,24,372,47,129,14,34,33,95,16,19,3,27,30,21,6,8,25,37,143
2150,Trent Whiting,JR,2014-15,F,Arkansas-Pine Bluff,SWAC,32,549,59,119,57,105,2,14,23,34,21,53,74,29,24,14,37,53,143
2151,Dion Wiley,FR,2014-15,G,Maryland,Big Ten,35,474,48,126,24,53,24,73,23,36,11,41,52,20,10,7,31,34,143
2152,Dominique Collier,FR,2014-15,G,Colorado,Pac-12,30,579,48,139,30,72,18,67,28,46,9,41,50,44,18,5,38,72,142
2153,Duby Okeke,FR,2014-15,C,Winthrop,Big South,32,439,57,82,57,82,0,0,28,51,46,42,88,6,6,46,34,72,142
2154,Bola Olaniyan,SO,2014-15,F,Southern Illinois,MVC,31,507,55,123,55,123,0,0,32,53,63,75,138,16,21,7,42,73,142
2155,James Palmer,FR,2014-15,G,Miami (FL),ACC,38,504,52,126,29,63,23,63,15,23,14,40,54,25,5,9,28,28,142
2156,Khaleen Pinkett,FR,2014-15,G,Savannah State,MEAC,29,682,55,141,51,120,4,21,28,61,17,45,62,32,42,3,85,58,142
2157,Marcus Wallace,FR,2014-15,G,Southeast Missouri State,OVC,29,460,47,100,34,66,13,34,35,51,15,33,48,44,35,3,35,50,142
2158,Tim Bond,SO,2014-15,G,Eastern Michigan,MAC,22,495,56,130,46,100,10,30,19,33,13,46,59,26,17,19,38,36,141
2159,Jeremiah Davis,JR,2014-15,G,Ball State,MAC,20,575,55,167,39,101,16,66,15,20,10,54,64,62,29,4,42,57,141
2160,Kris Gulley,SR,2014-15,G-F,Florida International,CUSA,33,656,54,139,30,50,24,89,9,16,22,80,102,24,22,6,32,59,141
2161,Zach Horstman,SR,2014-15,G-F,South Dakota State,Summit,33,506,50,107,37,69,13,38,28,43,32,47,79,17,10,5,18,57,141
2162,Elijah Macon,FR,2014-15,F,West Virginia,Big 12,33,433,55,120,55,120,0,0,31,60,42,46,88,25,10,16,41,63,141
2163,Jonah Travis,SR,2014-15,F,Harvard,Ivy,24,432,43,85,43,84,0,1,55,72,41,46,87,13,15,10,17,56,141
2164,Dallin Bachynski,SR,2014-15,C,Utah,Pac-12,34,426,47,88,46,86,1,2,45,65,26,58,84,7,10,11,15,64,140
2165,Iverson Fleming,SO,2014-15,G,Long Island University,NEC,30,555,46,132,24,64,22,68,26,40,6,28,34,43,23,1,32,63,140
2166,Rokas Gustys,FR,2014-15,F,Hofstra,CAA,27,446,59,103,59,103,0,0,22,53,73,80,153,21,21,12,30,83,140
2167,Derrick Henry,JR,2014-15,G,Winthrop,Big South,32,515,46,132,36,79,10,53,38,52,10,43,53,20,18,2,23,28,140
2168,David Joseph,JR,2014-15,G,Bowling Green State,MAC,33,709,50,168,40,116,10,52,30,35,9,73,82,109,30,0,56,47,140
2169,Jaylon Moore,SR,2014-15,F-C,Evansville,MVC,34,367,56,76,56,76,0,0,28,52,19,38,57,4,8,5,14,45,140
2170,C.J. Neumann,JR,2014-15,F,Wofford,Southern,35,718,48,93,48,93,0,0,44,67,62,96,158,26,18,7,27,74,140
2171,Tahj Shamsid-Deen,FR,2014-15,G,Auburn,SEC,23,534,48,134,30,71,18,63,26,36,5,21,26,35,16,0,17,42,140
2172,Zech Smith,SR,2014-15,C,Morgan State,MEAC,28,663,58,110,58,110,0,0,24,47,96,99,195,3,9,43,21,60,140
2173,Dustin Thomas,SO,2014-15,G-F,Colorado,Pac-12,32,535,49,110,43,91,6,19,36,53,26,53,79,29,12,8,34,81,140
2174,Jevon Thomas,SO,2014-15,G,Kansas State,Big 12,31,799,45,119,37,91,8,28,42,80,20,72,92,102,35,1,72,85,140
2175,Matt Willms,SO,2014-15,C,Texas-El Paso,CUSA,27,501,54,98,54,98,0,0,32,51,33,84,117,23,13,30,27,55,140
2176,Robert Champion,SO,2014-15,G,Holy Cross,Patriot,29,400,51,109,29,51,22,58,15,25,18,34,52,11,17,4,24,49,139
2177,Damonte Dodd,SO,2014-15,F,Maryland,Big Ten,35,555,51,84,51,84,0,0,37,59,47,85,132,22,7,51,35,93,139
2178,Denzel Dulin,JR,2014-15,G,Bethune-Cookman,MEAC,25,583,46,125,40,95,6,30,41,76,21,56,77,12,19,10,44,55,139
2179,Eddie Keith,FR,2014-15,F,Towson,CAA,30,545,41,111,38,93,3,18,54,94,21,52,73,43,11,16,54,74,139
2180,Matt Killian,JR,2014-15,F,Northwestern State,Southland,32,568,52,119,36,78,16,41,19,29,34,50,84,13,21,8,31,50,139
2181,Sanjay Lumpkin,SO,2014-15,G-F,Northwestern,Big Ten,32,720,50,95,37,60,13,35,26,38,33,87,120,26,21,9,27,91,139
2182,Tarin Smith,FR,2014-15,G,Nebraska,Big Ten,31,545,53,119,43,89,10,30,23,38,11,38,49,22,18,9,24,39,139
2183,Tyler Smithpeters,SO,2014-15,G,Southern Illinois,MVC,32,638,39,111,14,43,25,68,36,51,6,50,56,21,24,7,48,68,139
2184,Tony Wills,SO,2014-15,G,Illinois State,MVC,32,606,45,97,37,69,8,28,41,53,24,45,69,29,19,5,27,56,139
2185,Chris Adams,SR,2014-15,G,San Francisco,WCC,32,589,48,133,10,19,38,114,4,4,1,44,45,28,7,1,16,41,138
2186,Stephan Bennett,JR,2014-15,F,Robert Morris,NEC,32,589,54,133,50,123,4,10,26,43,27,37,64,15,12,14,27,81,138
2187,Nnamdi Enechionyia,SO,2014-15,G-F,Samford,Southern,32,461,47,132,17,42,30,90,14,23,22,36,58,21,17,13,19,48,138
2188,Brenden Evans,SR,2014-15,F,Utah Valley,WAC,27,527,53,128,51,123,2,5,30,46,46,53,99,26,11,4,31,79,138
2189,Calvin Godfrey,SR,2014-15,F,Memphis,AAC,31,438,50,115,50,115,0,0,38,60,45,66,111,10,18,24,23,67,138
2190,Denzel Keyes,SO,2014-15,G,North Carolina A&amp;T,MEAC,27,532,48,117,37,72,11,45,31,53,52,53,105,19,17,0,27,37,138
2191,Greg Malinowski,FR,2014-15,G-F,William &amp; Mary,CAA,33,544,48,110,19,48,29,62,13,19,23,47,70,21,12,4,37,48,138
2192,Durrell McDonald,JR,2014-15,G,DePaul,Big East,32,764,51,134,30,65,21,69,15,21,13,76,89,72,44,7,43,78,138
2193,Tarik Phillip,SO,2014-15,G,West Virginia,Big 12,34,439,45,96,39,68,6,28,42,61,21,30,51,28,38,2,33,49,138
2194,Josh Piper,SR,2014-15,F,Eastern Illinois,OVC,33,535,51,132,25,54,26,78,10,15,19,75,94,27,6,11,15,42,138
2195,Antonio Robinson,SR,2014-15,G,East Carolina,AAC,33,800,50,139,39,111,11,28,27,42,17,89,106,122,55,4,52,59,138
2196,Thomas Welsh,FR,2014-15,C,UCLA,Pac-12,36,565,62,132,62,132,0,0,14,23,54,83,137,8,14,39,17,85,138
2197,Delino Dear,JR,2014-15,F,Bethune-Cookman,MEAC,31,574,51,90,51,90,0,0,35,49,51,74,125,9,10,22,31,63,137
2198,Marshall Guilmette,SO,2014-15,F,East Carolina,AAC,22,451,50,122,39,85,11,37,26,38,24,50,74,24,5,9,33,66,137
2199,Khalid Nwandu,SO,2014-15,G,Mount St. Mary's,NEC,29,571,52,118,51,114,1,4,32,68,29,52,81,61,22,0,54,52,137
2200,Austin Quick,SR,2014-15,G,California-Riverside,Big West,30,551,48,124,33,69,15,55,26,47,17,52,69,67,27,3,40,53,137
2201,Bryant Rucker,JR,2014-15,G,Denver,Summit,29,532,49,106,32,57,17,49,22,32,5,39,44,39,12,0,32,59,137
2202,Corey Schaefer,SR,2014-15,G,Lehigh,Patriot,29,715,47,115,29,66,18,49,25,31,6,84,90,42,8,1,26,32,137
2203,Patson Siame,SO,2014-15,F,Loyola Marymount,WCC,24,481,63,139,63,138,0,1,11,28,29,67,96,6,5,25,33,68,137
2204,Amadou Sidibe,JR,2014-15,C,Fairfield,MAAC,24,547,54,110,54,110,0,0,29,42,56,107,163,16,12,3,30,56,137
2205,Yettra Specks,SO,2014-15,G,Jackson State,SWAC,31,707,45,161,22,73,23,88,24,38,12,49,61,55,29,2,60,72,137
2206,Leo Svete,FR,2014-15,G,IUPUI,Summit,31,435,44,148,14,36,30,112,19,27,2,25,27,9,7,1,23,36,137
2207,Christian Behrens,JR,2014-15,F,California,Pac-12,30,513,53,108,53,108,0,0,30,53,35,63,98,10,6,11,22,78,136
2208,Michael Bolden,SR,2014-15,G-F,Cal Poly,Big West,29,669,45,136,15,39,30,97,16,22,20,45,65,19,23,7,9,36,136
2209,Kentan Facey,SO,2014-15,F,Connecticut,AAC,31,665,57,105,56,104,1,1,21,29,60,102,162,12,7,12,19,67,136
2210,Darius Graham,SO,2014-15,G,California-Davis,Big West,32,857,42,113,26,72,16,41,36,53,12,41,53,102,16,0,74,58,136
2211,Evann Hall,SR,2014-15,G,Idaho State,Big Sky,30,442,50,141,44,118,6,23,30,61,7,58,65,14,22,1,30,43,136
2212,Ben Hazel,SR,2014-15,G-F,Princeton,Ivy,24,429,38,96,17,33,21,63,39,50,4,30,34,23,14,2,22,24,136
2213,Scottie Lindsey,FR,2014-15,G-F,Northwestern,Big Ten,31,467,51,126,28,61,23,65,11,17,13,57,70,17,10,15,20,60,136
2214,Tre' McLean,SO,2014-15,F,Chattanooga,Southern,32,702,47,136,35,74,12,62,30,46,20,77,97,36,25,5,34,70,136
2215,Martavious Newby,JR,2014-15,G,Mississippi,SEC,34,693,44,113,31,65,13,48,35,45,51,132,183,49,41,8,40,75,136
2216,Jamall Robinson,SO,2014-15,G-F,Hofstra,CAA,34,576,46,151,25,81,21,70,23,36,33,43,76,26,13,6,17,32,136
2217,Ke'Ron Brown,JR,2014-15,G,Hampton,MEAC,30,659,48,147,42,105,6,42,33,65,21,64,85,43,46,8,43,77,135
2218,Isaac Cohen,JR,2014-15,G,Columbia,Ivy,28,799,60,97,56,86,4,11,11,28,36,116,152,111,18,8,43,62,135
2219,L.J. Livingston,JR,2014-15,F-C,Miami (OH),MAC,31,449,55,84,55,84,0,0,25,44,38,52,90,3,4,29,17,42,135
2220,Isaiah Manderson,FR,2014-15,C,Texas Tech,Big 12,31,433,55,108,55,107,0,1,25,51,23,62,85,8,10,8,35,50,135
2221,Ja'Quan Newton,FR,2014-15,G,Miami (FL),ACC,34,459,45,111,41,101,4,10,41,64,8,35,43,47,8,4,39,34,135
2222,Jared Norsworthy,SR,2014-15,G,Howard,MEAC,32,559,43,106,32,70,11,36,38,65,24,47,71,13,27,4,36,62,135
2223,Isaac Thornton,SO,2014-15,G,San Jose State,MWC,29,805,45,156,35,97,10,59,35,56,12,85,97,63,36,22,67,86,135
2224,Evan Bailey,FR,2014-15,F,College of Charleston,CAA,32,514,46,129,18,40,28,89,14,22,21,45,66,12,11,2,12,57,134
2225,Jordan Baker,FR,2014-15,G,Old Dominion,CUSA,34,722,44,132,10,29,34,103,12,22,19,58,77,47,29,2,24,61,134
2226,Jason Carter,SR,2014-15,F,Texas Southern,SWAC,25,375,51,134,38,88,13,46,19,39,13,40,53,3,14,11,32,63,134
2227,Taylor Danaher,JR,2014-15,C,Mount St. Mary's,NEC,30,576,50,88,47,79,3,9,31,41,38,76,114,15,15,38,27,73,134
2228,Todd Hughes,FR,2014-15,G,Delaware State,MEAC,25,380,54,130,45,103,9,27,17,30,21,35,56,9,10,11,23,28,134
2229,Osa Izevbuwa,SO,2014-15,G,NJIT,Ind,32,430,48,119,23,57,25,62,13,23,11,33,44,19,12,1,27,35,134
2230,Jordan Johnson,SR,2014-15,G,Tennessee Tech,OVC,28,443,46,118,16,40,30,78,12,16,7,27,34,30,7,2,20,26,134
2231,Shaun Johnson,JR,2014-15,G,McNeese State,Southland,31,395,43,146,7,24,36,122,12,17,11,19,30,23,11,3,11,26,134
2232,Rakwan Kelly,FR,2014-15,F,Mississippi Valley State,SWAC,32,577,47,118,46,116,1,2,39,66,49,52,101,27,31,5,31,57,134
2233,Kevin Panzer,SR,2014-15,F,American,Patriot,21,508,44,130,29,82,15,48,31,54,10,53,63,47,7,17,39,58,134
2234,Paulius Satkus,FR,2014-15,F,James Madison,CAA,33,523,44,81,40,70,4,11,42,61,26,61,87,32,12,6,43,75,134
2235,Terence Smith,SR,2014-15,G,Mississippi,SEC,34,539,48,125,24,58,24,67,14,19,2,40,42,58,9,2,19,48,134
2236,Rasham Suarez,JR,2014-15,G,Southern Mississippi,CUSA,18,550,45,115,15,38,30,77,14,23,5,53,58,65,15,1,45,39,134
2237,Lance Tejada,FR,2014-15,G,East Carolina,AAC,33,458,42,138,22,67,20,71,30,55,4,39,43,55,15,1,33,38,134
2238,Kyle Thomas,SO,2014-15,F,Morgan State,MEAC,31,344,51,154,33,90,18,64,14,26,20,43,63,7,7,15,21,56,134
2239,Evan Wessel,JR,2014-15,G,Wichita State,MVC,32,756,47,120,16,34,31,86,9,17,48,69,117,22,25,5,14,44,134
2240,Jake Allsmiller,FR,2014-15,G,Georgia Southern,Sun Belt,31,656,44,120,4,9,40,111,5,8,6,49,55,27,13,3,20,61,133
2241,Chris Brady,SO,2014-15,C,Monmouth,MAAC,33,500,56,110,54,101,2,9,19,26,26,74,100,7,11,19,33,66,133
2242,Daquan Brickhouse,SR,2014-15,G,Coppin State,MEAC,18,414,41,112,22,60,19,52,32,35,14,29,43,39,21,0,21,28,133
2243,C.J. Gettys,SO,2014-15,C,North Carolina-Wilmington,CAA,30,432,53,109,53,109,0,0,27,46,37,71,108,10,6,31,11,87,133
2244,Josh Heath,SO,2014-15,G,Georgia Tech,ACC,31,605,47,114,44,101,3,13,36,53,9,35,44,83,20,3,40,37,133
2245,Quan Jones,JR,2014-15,G,Lamar,Southland,30,515,36,98,23,64,13,34,48,69,11,39,50,45,20,1,50,38,133
2246,Markese McGuire,SO,2014-15,G,Illinois-Chicago,Horizon,32,562,40,129,19,69,21,60,32,45,15,53,68,26,15,4,24,32,133
2247,Shadell Millinghaus,SO,2014-15,G,Southern Mississippi,CUSA,18,300,41,91,23,52,18,39,33,50,17,26,43,16,13,2,20,31,133
2248,Kameron Mitchell,SO,2014-15,G,Stony Brook,AEC,35,739,45,117,18,48,27,69,16,26,11,36,47,34,15,4,26,89,133
2249,Joe Retic,JR,2014-15,G,Liberty,Big South,20,560,40,115,31,84,9,31,44,55,10,40,50,98,38,3,73,51,133
2250,Skylar Spencer,JR,2014-15,F,San Diego State,MWC,36,841,50,94,50,94,0,0,33,69,71,113,184,11,19,91,25,66,133
2251,Amadi Udenyi,SO,2014-15,G,Pepperdine,WCC,22,572,41,123,17,62,24,61,27,41,8,38,46,97,17,1,41,38,133
2252,Antwoine Anderson,FR,2014-15,G,Fordham,A-10,29,530,37,101,28,73,9,28,49,74,5,27,32,70,22,5,61,60,132
2253,Shawn Anderson,FR,2014-15,G,Navy,Patriot,31,499,45,107,45,94,0,13,42,63,33,65,98,35,13,2,25,39,132
2254,Matt Christiansen,JR,2014-15,F,San Francisco,WCC,31,552,58,107,58,107,0,0,16,26,31,74,105,25,7,11,30,77,132
2255,Kevin Douglas,SR,2014-15,G-F,St. Francis (NY),NEC,26,399,46,109,32,63,14,46,26,39,30,57,87,13,11,11,25,55,132
2256,Jacob Kurtz,SR,2014-15,G,Florida,SEC,33,610,51,85,51,83,0,2,30,43,51,66,117,32,23,1,36,47,132
2257,Wyatt Lohaus,FR,2014-15,G,Northern Iowa,MVC,35,468,46,110,29,74,17,36,23,27,2,39,41,23,20,0,19,33,132
2258,Shelton Mitchell,FR,2014-15,G,Vanderbilt,SEC,31,619,45,123,38,92,7,31,35,49,5,53,58,103,4,3,60,34,132
2259,Elliott Pitts,SO,2014-15,G,Arizona,Pac-12,38,565,43,109,16,35,27,74,19,24,15,24,39,17,12,2,12,57,132
2260,Xavian Rimmer,SR,2014-15,G,Louisiana-Lafayette,Sun Belt,35,492,39,117,20,47,19,70,35,46,8,37,45,24,10,0,34,36,132
2261,K.J. Rose,SO,2014-15,G,Fairfield,MAAC,28,648,42,134,32,100,10,34,38,65,15,59,74,76,24,2,55,54,132
2262,John Ryan,SR,2014-15,C,California-Irvine,Big West,25,450,56,99,56,99,0,0,20,34,48,71,119,22,8,33,31,63,132
2263,J.J. Thompson,JR,2014-15,G,Southeast Missouri State,OVC,28,600,45,114,30,81,15,33,27,39,12,35,47,78,16,1,47,50,132
2264,Khalil Alford,JR,2014-15,G,Rider,MAAC,33,339,52,120,46,95,6,25,21,29,31,34,65,12,7,3,21,35,131
2265,Austin Keel,SR,2014-15,G,Central Michigan,MAC,30,254,46,90,33,46,13,44,26,36,8,32,40,15,10,1,17,13,131
2266,Moses Kingsley,FR,2014-15,C,Arkansas,SEC,36,390,49,101,49,101,0,0,33,53,45,45,90,11,15,38,23,56,131
2267,Richie Lewis,SO,2014-15,G,Nicholls State,Southland,26,671,44,119,40,99,4,20,39,57,13,44,57,68,45,4,76,70,131
2268,Nolan Long,SO,2014-15,F,Wagner,NEC,30,335,51,89,51,89,0,0,29,39,38,54,92,1,6,14,28,73,131
2269,Zach McCormick,FR,2014-15,G,Miami (OH),MAC,31,603,53,145,37,81,16,64,9,19,13,27,40,30,27,3,18,59,131
2270,Zac Tillman,SO,2014-15,C,Monmouth,MAAC,33,486,53,102,53,102,0,0,25,44,20,47,67,3,15,12,18,71,131
2271,Muhammad-Ali Abdur-Rahkman,FR,2014-15,G,Michigan,Big Ten,29,550,52,124,40,83,12,41,14,15,8,40,48,27,16,0,28,43,130
2272,Brett Boese,JR,2014-15,F,Washington State,Pac-12,30,494,46,122,11,25,35,97,3,6,12,24,36,32,7,2,15,33,130
2273,Zjori Bosha,FR,2014-15,G,Lamar,Southland,26,467,42,129,11,19,31,110,15,29,12,39,51,21,23,1,14,48,130
2274,Chris Chiozza,FR,2014-15,G,Florida,SEC,33,752,44,113,23,48,21,65,21,44,13,59,72,72,39,1,41,54,130
2275,Tanner Clayton,SR,2014-15,F,Stephen F. Austin,Southland,32,508,53,109,46,92,7,17,17,24,45,64,109,21,12,49,13,68,130
2276,Daniel Dingle,SO,2014-15,G-F,Temple,AAC,36,593,43,133,26,56,17,77,27,47,29,65,94,39,11,10,33,55,130
2277,P.J. Hardwick,SO,2014-15,G,Arkansas State,Sun Belt,27,776,42,119,40,109,2,10,44,55,21,64,85,130,19,0,59,55,130
2278,Dom Hoffman,JR,2014-15,F,Bucknell,Patriot,28,436,54,122,53,117,1,5,21,31,38,48,86,22,1,7,30,37,130
2279,Jahvari Josiah,SR,2014-15,G,Coppin State,MEAC,31,389,42,120,36,79,6,41,40,65,34,37,71,11,16,6,41,47,130
2280,Haiishen McIntyre,JR,2014-15,G,High Point,Big South,31,632,42,101,36,83,6,18,40,55,7,50,57,83,29,4,47,45,130
2281,Albert Owens,FR,2014-15,C,Oral Roberts,Summit,34,404,55,135,54,132,1,3,19,37,32,50,82,4,6,26,15,50,130
2282,Benny Parker,JR,2014-15,G,Nebraska,Big Ten,31,874,39,114,27,73,12,41,40,56,8,61,69,54,45,1,37,71,130
2283,Troy Reid-Knight,SO,2014-15,G,Maine,AEC,27,517,43,101,23,46,20,55,24,37,18,43,61,34,18,2,40,59,130
2284,Marial Shayok,FR,2014-15,G,Virginia,ACC,34,496,47,116,28,66,19,50,17,27,8,53,61,35,19,10,21,44,130
2285,Giacomo Zilli,FR,2014-15,F,North Carolina-Asheville,Big South,24,341,49,89,49,89,0,0,32,51,45,58,103,16,6,18,26,44,130
2286,Aaren Edmead,FR,2014-15,G,Wagner,NEC,30,460,40,120,16,54,24,66,25,42,11,14,25,41,13,0,40,47,129
2287,Kennedy Esume,JR,2014-15,C,Cal State Fullerton,Big West,31,461,54,108,54,108,0,0,21,46,36,65,101,5,9,19,26,60,129
2288,Armani Flannigan,SR,2014-15,F,North Texas,CUSA,29,428,50,95,50,95,0,0,29,51,36,41,77,5,17,17,18,41,129
2289,Daniel Gomis,JR,2014-15,F,Oregon State,Pac-12,30,642,44,96,44,96,0,0,41,70,48,68,116,16,14,41,39,93,129
2290,Zach Green,FR,2014-15,G,Montana State,Big Sky,30,510,50,123,49,112,1,11,28,41,34,33,67,25,14,7,24,58,129
2291,K.J. Lee,FR,2014-15,G,Marist,MAAC,30,783,45,113,31,75,14,38,25,39,11,67,78,50,21,2,45,32,129
2292,Jason McManamen,SO,2014-15,G,Wyoming,MWC,35,589,48,118,21,38,27,80,6,14,6,47,53,33,12,0,12,50,129
2293,David Rivers,SR,2014-15,G,Nebraska,Big Ten,30,709,52,109,51,108,1,1,24,39,56,70,126,20,13,7,16,75,129
2294,Collin Spickerman,JR,2014-15,F,Portland State,Big Sky,29,604,57,122,55,115,2,7,13,18,51,73,124,20,18,72,28,68,129
2295,Brandon Swannegan,JR,2014-15,F,Tulsa,AAC,34,569,44,96,44,96,0,0,41,74,64,72,136,4,19,49,28,84,129
2296,Ahmad Thomas,FR,2014-15,G,North Carolina-Asheville,Big South,23,404,51,128,44,101,7,27,20,35,15,62,77,24,19,9,31,31,129
2297,Kavon Waller,FR,2014-15,F,Delaware State,MEAC,36,491,46,85,29,46,17,39,20,26,27,37,64,16,3,5,24,54,129
2298,Adrion Webber,SR,2014-15,F,Oral Roberts,Summit,34,478,37,100,16,31,21,69,34,39,26,58,84,14,12,1,12,35,129
2299,Christian Wilson,FR,2014-15,G,Texas-San Antonio,CUSA,26,448,38,132,27,88,11,44,42,74,23,27,50,42,17,3,33,51,129
2300,Chris Bryant,JR,2014-15,F,Miami (OH),MAC,29,494,44,93,43,89,1,4,39,61,36,58,94,14,13,9,27,71,128
2301,Jalen Chapman,JR,2014-15,F,Western Illinois,Summit,26,452,51,121,51,121,0,0,26,50,33,78,111,12,25,18,43,58,128
2302,JerShon Cobb,SR,2014-15,G,Northwestern,Big Ten,21,469,44,109,20,43,24,66,16,22,7,61,68,33,4,1,19,35,128
2303,Ioannis Dimakopoulos,SO,2014-15,F-C,California-Irvine,Big West,34,369,57,126,51,105,6,21,8,13,15,41,56,14,4,23,19,48,128
2304,Jared Dimakos,JR,2014-15,G-F,Chicago State,WAC,21,378,44,98,27,51,17,47,23,30,19,47,66,13,12,0,34,57,128
2305,Strahinja Gavrilovic,JR,2014-15,F,Southern California,Pac-12,26,356,40,94,38,86,2,8,46,65,34,35,69,6,10,2,20,42,128
2306,Jacob Lawson,JR,2014-15,F,Appalachian State,Sun Belt,27,355,50,109,50,108,0,1,28,41,20,52,72,5,14,28,27,60,128
2307,Marin Maric,FR,2014-15,C,Northern Illinois,MAC,26,377,47,82,47,80,0,2,34,45,45,58,103,14,7,10,31,51,128
2308,Logan McLane,FR,2014-15,F,Miami (OH),MAC,32,457,52,102,43,77,9,25,15,27,27,56,83,18,17,6,25,61,128
2309,Evan Smotrycz,SR,2014-15,F,Maryland,Big Ten,27,533,39,121,21,59,18,62,32,42,24,88,112,34,14,10,29,53,128
2310,Anthony Walker,SR,2014-15,F,Texas-Arlington,Sun Belt,29,368,54,84,54,84,0,0,20,31,20,63,83,4,10,25,21,57,128
2311,Torin Childs-Harris,SO,2014-15,G,Morgan State,MEAC,22,395,40,126,32,83,8,43,39,55,18,28,46,11,19,1,20,45,127
2312,Damon Collins,SO,2014-15,G-F,Howard,MEAC,30,922,44,107,39,91,5,16,34,56,38,109,147,40,37,9,65,60,127
2313,Demetrius Henry,SO,2014-15,F-C,South Carolina,SEC,21,410,52,102,51,99,1,3,22,35,27,49,76,6,7,19,34,69,127
2314,Christian Kirk,SR,2014-15,F,Missouri State,MVC,29,448,51,98,51,98,0,0,25,40,33,53,86,12,9,16,30,54,127
2315,Jalen Lindsey,FR,2014-15,G,Providence,Big East,33,590,43,119,12,25,31,94,10,18,17,34,51,6,14,3,8,39,127
2316,Justin Mitchell,FR,2014-15,G,Wright State,Horizon,28,481,46,98,46,98,0,0,35,52,16,64,80,32,25,5,20,49,127
2317,Brandon Nazione,JR,2014-15,F,Eastern Michigan,MAC,35,538,44,111,42,96,2,15,37,54,42,82,124,16,19,12,32,68,127
2318,Ny Redding,FR,2014-15,G,Washington State,Pac-12,31,602,36,90,30,64,6,26,49,61,7,45,52,101,16,2,56,71,127
2319,Justin Tillman,FR,2014-15,F,Virginia Commonwealth,A-10,35,431,56,104,56,103,0,1,15,31,38,50,88,2,12,34,14,57,127
2320,Joey van Zegeren,JR,2014-15,F,Virginia Tech,ACC,13,265,57,95,57,94,0,1,13,41,30,39,69,3,5,18,15,33,127
2321,David Appolon,SR,2014-15,G,Robert Morris,NEC,21,460,39,96,35,82,4,14,44,59,29,45,74,34,22,0,30,50,126
2322,Casey Benson,FR,2014-15,G,Oregon,Pac-12,36,707,42,109,17,36,25,73,17,25,8,61,69,72,23,1,23,56,126
2323,Lennard Freeman,SO,2014-15,F,North Carolina State,ACC,35,681,51,114,51,114,0,0,24,48,70,127,197,19,9,7,23,63,126
2324,Ryann Green,SR,2014-15,G,Georgia State,Sun Belt,35,705,40,98,21,39,19,59,27,38,12,53,65,50,39,2,27,64,126
2325,Paul Jorgensen,FR,2014-15,G,George Washington,A-10,35,356,49,131,33,91,16,40,12,20,5,39,44,31,10,0,25,52,126
2326,Terrence Samuel,SO,2014-15,G,Connecticut,AAC,35,715,43,111,43,94,0,17,40,52,22,64,86,55,16,1,47,36,126
2327,Aaron Tate,JR,2014-15,F,Robert Morris,NEC,33,791,55,110,55,110,0,0,16,33,57,88,145,13,15,9,29,56,126
2328,Shawn Valentine,JR,2014-15,F,Rider,MAAC,32,578,43,120,22,54,21,66,19,37,30,36,66,31,17,5,31,52,126
2329,Keita Bates-Diop,FR,2014-15,F,Ohio State,Big Ten,33,327,44,93,26,54,18,39,19,28,13,55,68,17,11,19,13,24,125
2330,Joel Berry,FR,2014-15,G,North Carolina,ACC,30,397,40,99,23,51,17,48,28,37,3,23,26,46,12,1,21,44,125
2331,DeMondre Harvey,JR,2014-15,F,Louisiana-Monroe,Sun Belt,38,547,51,84,51,84,0,0,23,43,60,74,134,13,8,13,21,43,125
2332,Alex Larsson,FR,2014-15,F,California-Riverside,Big West,31,643,52,111,52,111,0,0,21,52,72,76,148,12,7,22,33,96,125
2333,Jake Newton,JR,2014-15,F,Southern Illinois-Edwardsville,OVC,28,425,38,117,12,53,26,64,23,31,14,36,50,19,13,3,32,43,125
2334,Randy Onwuasor,SO,2014-15,G,Texas Tech,Big 12,30,545,38,123,27,77,11,46,38,60,20,61,81,37,28,5,47,50,125
2335,Michael Rowley,SO,2014-15,F,Albany (NY),AEC,33,787,46,106,45,99,1,7,32,45,62,84,146,23,23,4,31,86,125
2336,Nate Sikma,SR,2014-15,F,Hartford,AEC,30,553,45,131,28,61,17,70,18,28,27,75,102,58,19,12,39,63,125
2337,Vacha Vaughn,SO,2014-15,F,Mississippi Valley State,SWAC,32,561,51,110,50,104,1,6,22,39,41,82,123,20,25,2,30,78,125
2338,Josiah Coleman,JR,2014-15,F,North Dakota,Big Sky,29,397,43,110,24,47,19,63,19,25,22,55,77,13,17,1,24,62,124
2339,Miguel Dicent,FR,2014-15,G,Morehead State,OVC,33,470,42,115,19,45,23,70,17,24,6,25,31,31,17,2,33,87,124
2340,Cameron Forte,JR,2014-15,F,Georgia,SEC,31,401,51,90,51,89,0,1,22,39,36,51,87,23,10,7,24,22,124
2341,Tai Odiase,FR,2014-15,F-C,Illinois-Chicago,Horizon,28,523,47,101,47,101,0,0,30,70,40,62,102,7,8,48,11,64,124
2342,Duran Porter,JR,2014-15,F,Abilene Christian,Southland,31,420,52,104,52,104,0,0,20,40,29,42,71,10,5,13,29,73,124
2343,Martin Smith,SR,2014-15,F,Lipscomb,A-Sun,14,346,39,106,27,59,12,47,34,44,11,33,44,27,14,2,19,19,124
2344,Bryce White,SO,2014-15,G,Portland State,Big Sky,13,339,34,91,23,55,11,36,45,58,5,48,53,23,9,5,17,30,124
2345,Wes Cole,SR,2014-15,G,Hartford,AEC,27,454,40,131,12,38,28,93,15,17,10,15,25,14,13,0,20,31,123
2346,Matt Hayes,SO,2014-15,G,Loyola Marymount,WCC,29,421,42,118,10,39,32,79,7,8,9,29,38,21,7,0,16,21,123
2347,Stephen Hurt,JR,2014-15,F,Kansas State,Big 12,29,388,46,102,42,88,4,14,27,39,32,49,81,12,7,7,31,54,123
2348,DeVante Jones,JR,2014-15,G,Middle Tennessee,CUSA,27,285,39,105,15,36,24,69,21,28,8,21,29,22,16,1,15,33,123
2349,Willy Kouassi,JR,2014-15,C,Kennesaw State,A-Sun,27,521,50,107,50,107,0,0,23,54,38,97,135,3,2,36,41,79,123
2350,Ben Lawson,SO,2014-15,F,Western Kentucky,CUSA,32,601,49,84,49,84,0,0,25,51,35,68,103,21,14,53,27,71,123
2351,Elijah Ray,SO,2014-15,F,IUPUI,Summit,27,302,46,96,38,72,8,24,23,33,18,51,69,6,7,0,29,38,123
2352,Trevin Woods,FR,2014-15,G-F,Long Island University,NEC,29,432,44,116,22,49,22,67,13,15,37,64,101,10,10,18,15,48,123
2353,C.J. Bray,JR,2014-15,F,Citadel,Southern,30,442,47,108,37,76,10,32,18,27,29,79,108,12,9,5,20,51,122
2354,Alex Davis,SR,2014-15,F,Fresno State,MWC,25,600,42,90,42,87,0,3,38,54,34,64,98,13,17,22,34,79,122
2355,Jacoby Green,JR,2014-15,G,Prairie View,SWAC,33,497,42,119,17,46,25,73,13,19,12,29,41,33,18,1,35,56,122
2356,Collin Jennings,FR,2014-15,G,Missouri-Kansas City,WAC,30,443,44,99,24,50,20,49,14,19,16,23,39,27,14,3,26,51,122
2357,Gus Leeper,SR,2014-15,F,Arkansas-Little Rock,Sun Belt,30,485,54,112,54,112,0,0,14,20,36,49,85,2,3,14,17,64,122
2358,Greg Louis,SR,2014-15,F,Pennsylvania,Ivy,27,514,53,95,53,94,0,1,16,32,39,70,109,15,16,15,33,74,122
2359,DeShon Minnis,JR,2014-15,G,Rhode Island,A-10,33,653,46,115,40,92,6,23,24,50,13,66,79,72,18,6,44,69,122
2360,Broderick Newbill,SO,2014-15,G-F,Missouri-Kansas City,WAC,29,350,49,106,45,89,4,17,20,39,21,41,62,10,19,8,29,29,122
2361,Andy Smeathers,JR,2014-15,F,Mount St. Mary's,NEC,14,318,37,109,10,25,27,84,21,25,13,43,56,14,9,6,28,31,122
2362,Montigo Alford,JR,2014-15,G,Boise State,MWC,30,352,43,108,24,64,19,44,16,26,1,26,27,38,13,4,29,33,121
2363,Mitch Brewe,JR,2014-15,F,California-Santa Barbara,Big West,31,488,45,103,36,79,9,24,22,36,42,38,80,16,8,7,22,49,121
2364,D.J. Foreman,FR,2014-15,F,Rutgers,Big Ten,32,486,48,110,45,101,3,9,22,49,35,51,86,16,6,5,31,52,121
2365,Marshall Harris,SR,2014-15,G,Citadel,Southern,27,550,35,70,13,26,22,44,29,32,9,25,34,77,27,0,53,42,121
2366,Brandon Hatton,FR,2014-15,G,Vermont,AEC,31,447,41,111,17,35,24,76,15,22,7,45,52,13,10,4,11,36,121
2367,Antonio Jenifer,JR,2014-15,F,St. Francis (NY),NEC,32,327,45,129,29,82,16,47,15,31,37,53,90,8,7,11,21,40,121
2368,Steve Johnston,SR,2014-15,G,Fairfield,MAAC,31,577,33,117,7,17,26,100,29,41,4,32,36,15,17,1,23,51,121
2369,Jamal Norman,FR,2014-15,G,Savannah State,MEAC,30,531,46,129,38,98,8,31,21,48,24,58,82,26,26,2,43,54,121
2370,Agunwa Okolie,JR,2014-15,G-F,Harvard,Ivy,28,694,52,100,51,91,1,9,16,33,32,74,106,27,20,13,29,38,121
2371,Keanau Post,SR,2014-15,F,Missouri,SEC,30,424,51,89,51,89,0,0,19,31,42,65,107,4,9,14,24,70,121
2372,Dusan Ristic,FR,2014-15,C,Arizona,Pac-12,36,308,48,78,44,73,4,5,21,41,21,54,75,2,2,9,9,45,121
2373,Marcus Stroman,FR,2014-15,G,South Carolina,SEC,28,573,39,104,37,86,2,18,41,63,16,57,73,87,22,4,57,61,121
2374,Aaron Wright,JR,2014-15,G,California-Irvine,Big West,33,567,40,100,28,71,12,29,29,50,12,54,66,52,26,2,51,69,121
2375,Mike Auger,FR,2014-15,F,Pennsylvania,Ivy,22,420,40,72,40,71,0,1,40,52,28,68,96,10,7,1,37,62,120
2376,Trivante Bloodman,SR,2014-15,G,Mississippi State,SEC,32,589,38,94,37,78,1,16,43,61,11,36,47,64,25,1,50,46,120
2377,Charles Buggs,SO,2014-15,F,Minnesota,Big Ten,33,437,45,103,29,53,16,50,14,28,25,41,66,17,9,6,9,46,120
2378,John Davis,FR,2014-15,G,Furman,Southern,32,639,40,122,24,66,16,56,24,41,7,34,41,44,16,0,36,46,120
2379,Cal Hanks,SR,2014-15,F-C,Southern Utah,Big Sky,29,259,40,82,40,81,0,1,40,68,8,50,58,5,8,14,25,46,120
2380,Noah Knight,FR,2014-15,G,Missouri-Kansas City,WAC,25,395,35,89,24,48,11,41,39,67,20,34,54,33,34,1,27,60,120
2381,Larry Lewis,FR,2014-15,G,Texas-San Antonio,CUSA,25,380,39,97,34,78,5,19,37,59,11,17,28,35,20,0,32,29,120
2382,Devonne Pinkard,SO,2014-15,G-F,Delaware,CAA,29,568,39,116,15,49,24,67,18,34,13,70,83,22,5,6,20,48,120
2383,Trey Pinkney,JR,2014-15,G,Stephen F. Austin,Southland,34,885,34,96,26,60,8,36,44,66,7,52,59,131,46,0,51,94,120
2384,Kerry Weldon,SR,2014-15,G,Massachusetts-Lowell,AEC,29,569,51,112,51,111,0,1,18,61,51,81,132,23,22,9,43,87,120
2385,Maurice Wiltz,SR,2014-15,G,Southern Illinois-Edwardsville,OVC,26,433,36,98,17,42,19,56,29,42,3,33,36,25,13,1,15,44,120
2386,Bryan Akinkugbe,SR,2014-15,C,North Carolina A&amp;T,MEAC,29,494,41,100,41,100,0,0,37,60,32,48,80,9,8,15,40,66,119
2387,Austin Anderson,JR,2014-15,G,Presbyterian,Big South,23,593,43,124,26,57,17,67,16,22,11,57,68,65,13,2,40,26,119
2388,Desonta Bradford,FR,2014-15,G,East Tennessee State,Southern,29,355,36,85,28,63,8,22,39,54,6,26,32,29,13,5,29,33,119
2389,Kyron Cartwright,FR,2014-15,G,Providence,Big East,34,639,46,121,42,88,4,33,23,31,7,46,53,89,22,2,41,41,119
2390,DJ Clayton,FR,2014-15,G,Western Kentucky,CUSA,29,466,45,130,28,71,17,59,12,27,34,36,70,21,10,5,25,36,119
2391,Will Darley,SO,2014-15,G,Maryland-Baltimore County,AEC,19,480,42,96,30,63,12,33,23,34,10,48,58,18,6,5,37,24,119
2392,Jordan Goodman,JR,2014-15,F,New Mexico,MWC,19,255,45,123,35,85,10,38,19,31,11,32,43,17,8,1,15,19,119
2393,Ayron Hutton,FR,2014-15,G,Quinnipiac,MAAC,26,529,42,132,12,48,30,84,5,11,13,53,66,62,11,0,42,43,119
2394,Donovon Jack,JR,2014-15,F,Penn State,Big Ten,34,444,43,95,40,77,3,18,30,40,36,57,93,10,15,26,22,97,119
2395,Jacob Lampkin,FR,2014-15,F,Pacific,WCC,31,573,47,94,47,94,0,0,25,43,48,92,140,25,5,11,37,67,119
2396,Emmanuel Owootoah,SO,2014-15,G,Fresno State,MWC,31,706,38,101,17,42,21,59,22,34,8,30,38,49,41,1,42,64,119
2397,Carson Shanks,FR,2014-15,C,North Dakota,Big Sky,19,373,42,99,40,90,2,9,33,54,18,51,69,13,1,27,25,59,119
2398,George Thomas,SO,2014-15,F,Alcorn State,SWAC,32,597,37,115,18,44,19,71,26,42,34,78,112,16,24,13,28,72,119
2399,Matthew Grant,SO,2014-15,G,Detroit Mercy,Horizon,33,679,38,116,19,50,19,66,23,30,11,64,75,54,22,5,22,62,118
2400,John Johnson,SR,2014-15,G,Penn State,Big Ten,16,330,33,77,20,42,13,35,39,55,6,21,27,23,11,0,17,20,118
2401,Anthony Lindauer,SO,2014-15,G,High Point,Big South,30,366,37,90,12,30,25,60,19,19,3,42,45,27,18,3,28,34,118
2402,Kyle Noreen,SR,2014-15,F,Radford,Big South,34,744,47,102,35,58,12,44,12,26,36,51,87,54,12,12,20,79,118
2403,Dane Pineau,SO,2014-15,F,Saint Mary's (CA),WCC,31,444,50,90,44,65,6,25,12,19,34,81,115,27,10,15,23,41,118
2404,Tai Webster,SO,2014-15,G,Nebraska,Big Ten,30,550,39,109,27,57,12,52,28,38,12,45,57,35,21,4,39,64,118
2405,Vinny Zollo,JR,2014-15,F,Cleveland State,Horizon,33,427,41,119,21,55,20,64,16,24,26,62,88,22,5,10,23,49,118
2406,Reggie Agbeko,SO,2014-15,F,Saint Louis,A-10,32,455,43,82,43,82,0,0,31,51,38,74,112,2,7,0,30,46,117
2407,Jovan Austin,JR,2014-15,G,Bowling Green State,MAC,33,545,36,95,29,73,7,22,38,60,7,40,47,87,16,3,63,36,117
2408,Jaylen Babb-Harrison,SO,2014-15,G,Eastern Kentucky,OVC,21,264,42,105,21,43,21,62,12,15,8,25,33,21,15,0,16,20,117
2409,Mohamed Bah,SO,2014-15,F,Drexel,CAA,30,656,42,77,42,75,0,2,33,41,47,92,139,14,14,19,24,86,117
2410,Sandy Cohen,FR,2014-15,F,Marquette,Big East,31,465,39,105,17,39,22,66,17,28,5,44,49,26,16,7,22,48,117
2411,Nate Hicks,SR,2014-15,F-C,Florida Gulf Coast,A-Sun,31,479,40,73,40,72,0,1,37,54,41,94,135,8,5,25,13,42,117
2412,Nehemiah Mabson,FR,2014-15,F,Campbell,Big South,31,365,42,102,31,67,11,35,22,45,22,32,54,22,10,4,38,72,117
2413,Alex Murphy,JR,2014-15,F,Florida,SEC,23,327,42,92,36,59,6,33,27,44,11,35,46,6,9,6,21,34,117
2414,Pookie Powell,SO,2014-15,G,Memphis,AAC,27,416,43,114,28,62,15,52,16,24,4,32,36,72,20,4,54,30,117
2415,Anthony Thompson,SO,2014-15,G,Holy Cross,Patriot,20,474,37,116,18,53,19,63,24,43,14,29,43,40,26,0,20,42,117
2416,Darrick Wood,SO,2014-15,G,DePaul,Big East,27,364,45,124,30,79,15,45,12,24,11,28,39,29,9,1,42,45,117
2417,Kasim Chandler,SO,2014-15,G,Quinnipiac,MAAC,26,460,28,99,26,85,2,14,58,71,26,41,67,74,10,1,51,31,116
2418,Avery Dingman,SR,2014-15,G,Creighton,Big East,28,552,35,104,17,48,18,56,28,43,12,66,78,28,7,10,25,53,116
2419,Blake Hibbitts,JR,2014-15,F,Central Michigan,MAC,32,486,39,114,11,23,28,91,10,16,23,57,80,10,10,6,11,45,116
2420,Jason McClellan,JR,2014-15,F,Illinois-Chicago,Horizon,25,419,44,114,32,69,12,45,16,20,36,63,99,9,11,17,14,59,116
2421,Jarad Scott,SO,2014-15,F,Winthrop,Big South,27,353,42,84,25,44,17,40,15,18,30,46,76,10,11,8,21,57,116
2422,Jaylon Tate,SO,2014-15,G,Illinois,Big Ten,32,652,28,76,27,64,1,12,59,70,2,37,39,92,26,3,45,59,116
2423,Mike Best,JR,2014-15,F,California-Irvine,Big West,34,399,46,99,46,98,0,1,23,34,23,53,76,9,8,21,10,62,115
2424,Terrell Brown,JR,2014-15,F,Montana State,Big Sky,28,472,38,107,27,80,11,27,28,32,18,39,57,20,7,2,30,54,115
2425,Kameron Chatman,FR,2014-15,G-F,Michigan,Big Ten,32,486,42,132,32,94,10,38,21,31,20,61,81,22,13,6,29,46,115
2426,Zena Edosomwan,SO,2014-15,F,Harvard,Ivy,29,350,43,109,43,109,0,0,29,48,35,56,91,7,6,19,29,53,115
2427,Darin Johnson,SO,2014-15,G,Washington,Pac-12,26,447,32,107,24,64,8,43,43,55,10,32,42,19,8,4,17,32,115
2428,Iman Johnson,JR,2014-15,F,Maryland-Eastern Shore,MEAC,31,549,46,104,45,103,1,1,22,40,38,61,99,29,23,4,35,65,115
2429,Corbin Kaufasi,FR,2014-15,C,Brigham Young,WCC,34,560,36,64,36,64,0,0,43,70,57,76,133,3,11,34,34,117,115
2430,Tamron Manning,JR,2014-15,G,Marshall,CUSA,31,503,42,119,35,88,7,31,24,43,9,50,59,48,29,2,41,51,115
2431,A.C. Reid,FR,2014-15,G-F,Liberty,Big South,29,525,37,130,8,25,29,105,12,17,6,45,51,32,11,2,30,48,115
2432,Victor Sanders,FR,2014-15,G,Idaho,Big Sky,30,379,36,91,15,37,21,54,22,35,11,39,50,28,10,3,29,42,115
2433,Jamal Shabazz,JR,2014-15,G-F,Samford,Southern,26,393,41,106,30,73,11,33,22,42,32,56,88,16,15,16,31,65,115
2434,Kahlil Thomas,SO,2014-15,F,Rider,MAAC,20,368,45,93,42,81,3,12,22,45,26,51,77,15,6,13,23,47,115
2435,Austin Williams,FR,2014-15,G,North Carolina A&amp;T,MEAC,29,520,41,130,37,106,4,24,29,68,22,43,65,68,35,2,85,61,115
2436,Temidayo Yussuf,FR,2014-15,F,Long Beach State,Big West,33,435,38,78,38,78,0,0,39,75,39,48,87,16,9,11,30,72,115
2437,Dominique Dunning,JR,2014-15,G,California-Irvine,Big West,27,422,42,93,35,74,7,19,23,34,32,75,107,23,13,7,20,47,114
2438,James Hajek,SR,2014-15,C,Weber State,Big Sky,30,529,46,87,46,87,0,0,22,35,42,81,123,12,7,24,19,68,114
2439,Isaiah Ivey,JR,2014-15,G,Gardner-Webb,Big South,33,508,40,104,27,55,13,49,21,28,17,49,66,30,11,9,17,34,114
2440,Mike Laster,FR,2014-15,G,Ohio,MAC,30,563,43,99,39,88,4,11,24,32,23,29,52,10,9,1,25,38,114
2441,Ethan Layer,JR,2014-15,G,Liberty,Big South,32,358,32,85,3,6,29,79,21,27,5,25,30,24,7,2,14,39,114
2442,Zachary Lee,FR,2014-15,F,Tennessee State,OVC,31,593,44,105,44,103,0,2,26,44,34,57,91,13,13,15,33,68,114
2443,Zach McRoberts,FR,2014-15,F,Vermont,AEC,27,541,42,86,36,69,6,17,24,40,37,82,119,24,17,9,18,54,114
2444,Ryan Winters,SR,2014-15,F,Elon,CAA,20,487,43,99,43,99,0,0,28,40,42,54,96,14,4,2,22,57,114
2445,Joe Bramanti,JR,2014-15,G,New Hampshire,AEC,25,630,32,79,22,56,10,23,39,69,15,68,83,61,19,0,38,64,113
2446,Tre Campbell,FR,2014-15,G,Georgetown,Big East,33,452,37,98,16,40,21,58,18,26,4,30,34,29,19,0,10,30,113
2447,Tommy Carpenter,JR,2014-15,F,Dartmouth,Ivy,29,404,46,82,45,76,1,6,20,40,20,65,85,32,14,9,31,46,113
2448,Jakeenan Gant,FR,2014-15,F,Missouri,SEC,23,324,47,91,46,77,1,14,18,25,20,30,50,7,9,14,16,33,113
2449,Austin Gillmann,FR,2014-15,C,Saint Louis,A-10,32,496,44,99,28,53,16,46,9,18,15,52,67,34,4,12,33,54,113
2450,Zach Hanson,SO,2014-15,F,Creighton,Big East,30,344,47,86,47,86,0,0,19,30,30,42,72,4,10,10,33,51,113
2451,Corey Littlejohn,SR,2014-15,G,North Carolina-Asheville,Big South,29,516,36,100,23,53,13,47,28,37,28,53,81,39,29,3,42,56,113
2452,Tony Sabato,JR,2014-15,C,Elon,CAA,32,533,47,126,47,126,0,0,19,41,27,46,73,25,4,9,24,87,113
2453,Greg Senat,SO,2014-15,F,Wagner,NEC,29,474,46,93,46,93,0,0,21,39,56,69,125,5,14,14,25,100,113
2454,Tim Smallwood,JR,2014-15,G,Nebraska-Omaha,Summit,25,380,39,109,21,40,18,69,17,34,8,43,51,23,19,3,23,41,113
2455,Cory Starkey,SR,2014-15,F,Bucknell,Patriot,31,563,45,94,45,94,0,0,23,32,44,100,144,39,6,7,35,45,113
2456,Dwight Tarwater,SR,2014-15,F,California,Pac-12,33,619,42,110,18,31,24,79,5,6,26,70,96,16,6,4,17,49,113
2457,Dinjiyl Walker,JR,2014-15,G,Oklahoma,Big 12,34,360,41,113,27,60,14,53,17,27,8,24,32,18,12,3,27,52,113
2458,Jorge Bilbao,SO,2014-15,F,Texas-Arlington,Sun Belt,30,470,46,74,46,72,0,2,20,37,39,58,97,19,15,9,24,75,112
2459,Albert Christensson,FR,2014-15,F-C,Central Arkansas,Southland,27,341,40,96,29,65,11,31,21,45,21,34,55,10,4,1,39,46,112
2460,Tramaine Isabell,FR,2014-15,G,Missouri,SEC,27,405,37,118,21,66,16,52,22,28,9,27,36,39,17,0,33,35,112
2461,Landen Lucas,SO,2014-15,F,Kansas,Big 12,32,485,41,77,41,77,0,0,30,45,51,88,139,12,9,18,31,70,112
2462,Odera Nweke,SR,2014-15,F-G,NJIT,Ind,33,562,41,88,41,87,0,1,30,52,35,59,94,33,10,21,34,65,112
2463,Larry Wideman,JR,2014-15,G,Furman,Southern,32,562,39,121,18,47,21,74,13,21,9,46,55,35,9,4,33,49,112
2464,Javon Baumann,SO,2014-15,C,Saint Joseph's,A-10,31,610,48,74,48,74,0,0,15,40,45,70,115,18,12,39,30,87,111
2465,Johnny Griffin,FR,2014-15,G-F,Chicago State,WAC,31,574,41,86,40,73,1,13,28,50,47,74,121,9,34,21,20,72,111
2466,Travis Jorgenson,FR,2014-15,G,Georgia Tech,ACC,30,651,42,135,27,85,15,50,12,16,3,38,41,100,22,3,54,20,111
2467,Kenneth Lowe,SO,2014-15,F,Green Bay,Horizon,33,638,48,92,48,92,0,0,15,45,29,56,85,24,18,19,31,71,111
2468,Tyler McCullough,SO,2014-15,C,Missouri State,MVC,30,418,45,99,45,99,0,0,21,29,42,38,80,7,8,31,18,64,111
2469,Malachi Nix,SO,2014-15,G,Fairleigh Dickinson,NEC,28,433,24,80,15,54,9,26,54,67,4,21,25,53,29,0,46,43,111
2470,Michael Orris,SO,2014-15,G,Northern Illinois,MAC,30,786,38,116,28,70,10,46,25,39,12,35,47,62,25,1,52,74,111
2471,Luke Piotrowski,JR,2014-15,C,Eastern Illinois,OVC,31,397,45,92,45,92,0,0,21,30,27,37,64,12,7,31,18,31,111
2472,Dontaveon Robinson,SO,2014-15,G,Jackson State,SWAC,32,522,46,122,46,120,0,2,19,33,22,29,51,28,22,8,40,73,111
2473,Miles Simelton,SO,2014-15,G,Lehigh,Patriot,30,467,38,98,21,47,17,51,18,23,4,30,34,39,20,3,29,40,111
2474,Travis Elliott,SR,2014-15,C,Bethune-Cookman,MEAC,26,485,45,80,45,80,0,0,20,41,57,77,134,11,8,5,39,83,110
2475,Hari Hall,FR,2014-15,F,James Madison,CAA,19,283,40,96,28,62,12,34,18,26,13,38,51,6,6,2,22,18,110
2476,Jordan Jackson,SR,2014-15,G,Northern Kentucky,A-Sun,29,396,36,73,34,68,2,5,36,48,4,39,43,44,18,10,39,35,110
2477,Eric James,FR,2014-15,G,Duquesne,A-10,24,275,37,91,24,44,13,47,23,41,22,35,57,11,14,1,16,27,110
2478,Darius Lewis,SO,2014-15,C,Duquesne,A-10,31,455,39,76,39,76,0,0,32,57,27,69,96,11,1,31,32,86,110
2479,Stuckey Mosley,FR,2014-15,G,Toledo,MAC,33,345,37,103,26,63,11,40,25,40,4,24,28,17,14,4,19,39,110
2480,Garland Owens,SO,2014-15,F,Boston College,ACC,32,530,47,92,44,79,3,13,13,21,24,39,63,17,6,5,25,53,110
2481,Kevin Seymour,FR,2014-15,G,Central Connecticut State,NEC,28,846,44,120,33,84,11,36,11,18,8,60,68,96,17,5,57,29,110
2482,Rasean Simpson,JR,2014-15,G,Morgan State,MEAC,26,376,40,118,38,100,2,18,28,45,45,29,74,10,15,4,22,41,110
2483,Christian Terrell,FR,2014-15,G,Florida Gulf Coast,A-Sun,33,391,38,99,19,44,19,55,15,20,7,45,52,26,9,7,28,33,110
2484,Deontae Cole,SO,2014-15,F,Northern Kentucky,A-Sun,27,384,37,93,5,12,32,81,3,6,8,25,33,9,4,5,6,19,109
2485,Chase Comier,SO,2014-15,G,Grambling,SWAC,23,676,30,108,25,76,5,32,44,71,11,58,69,75,27,0,58,59,109
2486,Ivan Cruz Uceda,JR,2014-15,F,Miami (FL),ACC,21,360,37,99,16,37,21,62,14,17,18,56,74,4,8,5,13,19,109
2487,Rod Days,JR,2014-15,F,Campbell,Big South,32,550,36,118,21,58,15,60,22,39,27,42,69,23,15,12,25,46,109
2488,Kelvin Downs,JR,2014-15,F,Arkansas State,Sun Belt,28,502,42,111,41,106,1,5,24,37,23,54,77,5,4,16,34,75,109
2489,Zachary Hamilton,FR,2014-15,F,Prairie View,SWAC,32,408,43,100,42,94,1,6,22,27,27,33,60,11,16,3,20,49,109
2490,Chuks Iroegbu,JR,2014-15,G,Northern Illinois,MAC,30,326,35,59,33,46,2,13,37,68,16,27,43,11,18,3,24,30,109
2491,Gerdarius Troutman,FR,2014-15,G,South Carolina State,MEAC,31,313,33,125,11,26,22,99,21,28,12,25,37,19,9,0,7,18,109
2492,Lowell Ulmer,SR,2014-15,F,St. Francis (NY),NEC,35,542,38,91,31,68,7,23,26,47,35,39,74,28,22,10,28,84,109
2493,Mark Williams,SO,2014-15,F,Temple,AAC,31,410,37,114,25,71,12,43,23,37,27,55,82,22,2,5,28,48,109
2494,Chancellor Barnard,FR,2014-15,G,Loyola (MD),Patriot,30,557,36,83,36,80,0,3,36,57,41,59,100,18,5,26,31,53,108
2495,Antwon Clayton,FR,2014-15,F,Jacksonville,A-Sun,29,625,40,90,40,86,0,4,28,58,63,87,150,19,25,33,32,86,108
2496,John Golden,SR,2014-15,F,Dartmouth,Ivy,22,544,42,109,34,76,8,33,16,26,16,48,64,33,19,5,23,40,108
2497,Paul Gombwer,SR,2014-15,F,Charleston Southern,Big South,31,644,39,102,29,61,10,41,20,33,63,132,195,25,23,5,34,72,108
2498,LeMon Gregory,JR,2014-15,C,Lamar,Southland,27,390,51,76,51,76,0,0,6,19,33,58,91,8,6,11,30,61,108
2499,Mitchell Hahn,FR,2014-15,F,Holy Cross,Patriot,23,303,34,76,15,25,19,51,21,27,11,39,50,23,4,13,21,27,108
2500,Jernard Jarreau,SO,2014-15,F,Washington,Pac-12,21,510,43,102,37,91,6,11,16,27,20,79,99,23,11,15,28,62,108
2501,Donovan Kates,SR,2014-15,G,Manhattan,MAAC,32,749,30,99,15,40,15,59,33,44,22,49,71,32,14,3,25,60,108
2502,Chris McComber,SO,2014-15,F,Columbia,Ivy,28,510,35,113,6,16,29,97,9,12,18,27,45,9,6,5,11,49,108
2503,Andre Nation,JR,2014-15,G,James Madison,CAA,12,330,40,92,36,68,4,24,24,40,10,20,30,22,20,4,25,25,108
2504,Paris Roberts-Campbell,SR,2014-15,G,East Carolina,AAC,22,416,37,95,11,26,26,69,8,11,10,39,49,24,21,6,12,34,108
2505,Bryan Sekunda,FR,2014-15,G-F,Stony Brook,AEC,32,405,35,114,5,31,30,83,8,8,10,19,29,16,7,3,25,22,108
2506,Tavarius Shine,FR,2014-15,G-F,Oklahoma State,Big 12,32,420,37,89,16,23,21,66,13,21,16,36,52,10,16,8,24,49,108
2507,Jeremie Tyler,FR,2014-15,G,Ball State,MAC,9,272,41,89,23,47,18,42,8,11,7,27,34,12,12,3,19,20,108
2508,Tyler Wilson,SO,2014-15,G,Manhattan,MAAC,33,681,28,70,27,65,1,5,51,87,11,40,51,96,44,1,63,82,108
2509,Stephen Brown,FR,2014-15,G,Bucknell,Patriot,30,441,40,91,32,73,8,18,19,40,7,52,59,42,9,1,22,41,107
2510,Donaven Dorsey,FR,2014-15,F,Washington,Pac-12,28,412,34,100,4,11,30,89,9,15,8,39,47,7,3,3,12,61,107
2511,Justin Gray,FR,2014-15,F,Texas Tech,Big 12,16,301,37,75,37,67,0,8,33,46,17,28,45,8,10,9,14,25,107
2512,Coleman Johnson,JR,2014-15,F,Fairfield,MAAC,28,541,38,108,38,108,0,0,31,40,41,61,102,19,15,41,27,91,107
2513,D.J. MacLeay,SO,2014-15,F,Bucknell,Patriot,30,353,39,89,39,85,0,4,29,47,37,58,95,17,13,6,15,54,107
2514,Jordan Mason,JR,2014-15,G,Cal State Fullerton,Big West,19,249,40,95,28,51,12,44,15,22,12,32,44,11,7,1,15,30,107
2515,Josh Oglesby,SR,2014-15,G,Iowa,Big Ten,33,625,35,124,7,28,28,96,9,9,14,48,62,48,11,2,21,28,107
2516,Jarvis Pugh,FR,2014-15,G,Santa Clara,WCC,32,633,51,88,50,85,1,3,4,13,48,71,119,35,26,8,23,84,107
2517,Kem Ubaru,FR,2014-15,F,North Carolina-Asheville,Big South,13,242,37,85,33,77,4,8,29,44,19,42,61,8,10,0,34,30,107
2518,Zavion Williams,JR,2014-15,G,Austin Peay,OVC,23,373,38,106,27,62,11,44,20,31,13,31,44,42,22,0,38,51,107
2519,Abdul Ahmed,SR,2014-15,C,Cal State Bakersfield,WAC,33,426,37,103,20,44,17,59,15,21,18,47,65,23,4,5,22,60,106
2520,D'Angelo Allen,FR,2014-15,F,Missouri,SEC,32,544,40,98,31,78,9,20,17,28,37,63,100,21,11,7,18,62,106
2521,Ore Arogundade,FR,2014-15,G,Drake,MVC,29,371,31,77,17,51,14,26,30,41,10,37,47,19,15,1,28,40,106
2522,Jamaal Calvin,SO,2014-15,G,Southeast Missouri State,OVC,27,447,32,89,9,20,23,69,19,23,12,25,37,21,12,0,15,35,106
2523,Kevin Crescenzi,JR,2014-15,G,Dartmouth,Ivy,29,495,33,111,12,53,21,58,19,24,23,39,62,20,22,2,19,56,106
2524,Shaheed Davis,JR,2014-15,F,Central Florida,AAC,24,333,37,101,28,73,9,28,23,47,22,49,71,8,10,14,33,29,106
2525,Jamel Fields,SR,2014-15,G,Saint Peter's,MAAC,34,543,26,73,14,38,12,35,42,67,4,48,52,45,20,9,37,54,106
2526,Isaac Neilson,FR,2014-15,C,Brigham Young,WCC,34,308,39,79,31,56,8,23,20,32,34,48,82,5,10,10,13,56,106
2527,Trey Porter,FR,2014-15,F,George Mason,A-10,30,423,37,79,37,77,0,2,32,55,19,59,78,5,11,33,20,75,106
2528,Marvin Smith,JR,2014-15,F,South Carolina Upstate,A-Sun,35,435,41,86,38,73,3,13,21,35,33,51,84,19,4,7,20,32,106
2529,Muhammed Ahmed,JR,2014-15,F,North Texas,CUSA,28,288,40,112,37,90,3,22,22,44,31,38,69,2,9,12,16,22,105
2530,Riley Bradshaw,SO,2014-15,G,Montana,Big Sky,33,509,38,103,22,51,16,52,13,15,8,32,40,34,6,1,28,42,105
2531,Anthony Drmic,SR,2014-15,G-F,Boise State,MWC,7,248,33,77,17,34,16,43,23,30,7,28,35,11,5,0,9,16,105
2532,Emmitt Holt,FR,2014-15,F,Indiana,Big Ten,29,332,39,60,39,60,0,0,27,50,38,48,86,5,7,21,11,48,105
2533,Stephan Jiggetts,FR,2014-15,G,Fairleigh Dickinson,NEC,20,327,33,116,19,67,14,49,25,35,10,18,28,23,8,1,41,35,105
2534,John Jones,SR,2014-15,F,Illinois State,MVC,34,445,47,87,47,86,0,1,11,28,40,67,107,9,12,21,29,72,105
2535,Malik Marquetti,FR,2014-15,G,Southern California,Pac-12,32,600,38,110,23,60,15,50,14,25,30,56,86,29,22,6,21,61,105
2536,Greg McClinton,FR,2014-15,F,Wake Forest,ACC,31,454,39,91,39,87,0,4,27,43,41,48,89,26,13,9,30,48,105
2537,Travin Thibodeaux,FR,2014-15,F,New Orleans,Southland,29,539,40,78,40,77,0,1,25,40,35,87,122,10,17,29,25,81,105
2538,Shore Adenekan,JR,2014-15,F,Seattle,WAC,26,412,42,74,42,74,0,0,20,43,30,51,81,9,7,14,18,45,104
2539,Jimmie Duplessis,JR,2014-15,G,Southeastern Louisiana,Southland,23,448,37,97,32,73,5,24,25,44,8,36,44,60,12,0,40,38,104
2540,Marcus Harris,FR,2014-15,G,San Diego,WCC,31,336,35,91,16,36,19,55,15,24,6,18,24,12,6,1,14,34,104
2541,Ralph Hill,SR,2014-15,F,Oakland,Horizon,32,299,33,77,9,12,24,65,14,16,5,27,32,16,7,3,8,33,104
2542,B.J. Johnson,SO,2014-15,F,Syracuse,ACC,25,366,35,114,19,53,16,61,18,25,26,53,79,12,14,5,17,26,104
2543,Matthew Moss,JR,2014-15,C,McNeese State,Southland,31,425,38,107,21,43,17,64,11,17,19,32,51,6,12,4,14,89,104
2544,Detrick Mostella,FR,2014-15,G,Tennessee,SEC,31,364,34,123,12,42,22,81,14,20,8,19,27,15,9,1,30,34,104
2545,Cole Murray,SO,2014-15,G,Northern Kentucky,A-Sun,26,261,36,86,4,5,32,81,0,0,1,25,26,7,5,1,6,33,104
2546,Chinanu Onuaku,FR,2014-15,F-C,Louisville,ACC,35,623,45,73,45,73,0,0,14,30,69,91,160,19,26,42,44,83,104
2547,Randy Reed,JR,2014-15,G,Nebraska-Omaha,Summit,27,316,38,66,36,57,2,9,26,37,18,34,52,12,11,9,17,33,104
2548,Miles Reynolds,FR,2014-15,G,Saint Louis,A-10,26,327,19,66,17,47,2,19,64,87,7,34,41,30,17,1,27,37,104
2549,Brad Schaub,FR,2014-15,G-F,Massachusetts-Lowell,AEC,22,539,39,94,23,61,16,33,10,22,12,53,65,16,16,5,35,55,104
2550,Kamryn Williams,SR,2014-15,F,Air Force,MWC,11,310,38,78,36,63,2,15,26,35,25,41,66,30,17,9,25,29,104
2551,DeVince Boykins,JR,2014-15,G,Marshall,CUSA,30,463,41,88,33,70,8,18,13,37,16,30,46,42,15,1,44,31,103
2552,Jaryd Eustace,SO,2014-15,G,Miami (OH),MAC,28,322,32,106,7,25,25,81,14,23,6,43,49,4,5,1,16,21,103
2553,Jamel Fuentes,SR,2014-15,G,Norfolk State,MEAC,33,832,35,106,35,98,0,8,33,51,16,78,94,138,33,3,66,88,103
2554,Kyle Kuzma,FR,2014-15,F,Utah,Pac-12,31,252,36,79,25,45,11,34,20,36,10,45,55,19,1,5,18,32,103
2555,Brandon Mitchell,SO,2014-15,F,San Jose State,MWC,28,547,33,108,27,80,6,28,31,58,48,91,139,8,22,11,29,64,103
2556,Shavar Newkirk,FR,2014-15,G,Saint Joseph's,A-10,31,622,34,121,28,89,6,32,29,51,9,43,52,71,22,5,44,37,103
2557,Frank Okeke,JR,2014-15,F,New Hampshire,AEC,31,487,34,100,12,24,22,76,13,24,8,38,46,20,2,10,18,28,103
2558,Edward Simpson,FR,2014-15,G,Middle Tennessee,CUSA,35,524,36,96,13,36,23,60,8,17,5,39,44,25,13,3,18,34,103
2559,Denzell Taylor,SO,2014-15,F,Old Dominion,CUSA,35,847,44,80,44,80,0,0,15,34,125,84,209,46,37,23,44,97,103
2560,Jeff White,JR,2014-15,G,Loyola (IL),MVC,35,686,35,97,27,69,8,28,25,32,7,49,56,82,31,2,42,48,103
2561,Jonathan Wilkins,FR,2014-15,F,New Mexico State,WAC,34,589,40,84,40,83,0,1,23,43,44,40,84,22,9,11,33,61,103
2562,Ruben Arroyo-Felix,FR,2014-15,F,Presbyterian,Big South,32,387,46,106,39,80,7,26,3,9,16,27,43,4,9,4,19,34,102
2563,Mark Blackmon,SO,2014-15,G,Maryland-Eastern Shore,MEAC,33,280,32,70,24,46,8,24,30,39,9,18,27,11,22,0,12,38,102
2564,Adrian Edwards,SO,2014-15,F,Alabama A&amp;M,SWAC,29,435,43,98,43,96,0,2,16,36,37,41,78,5,7,9,35,57,102
2565,Chuck Ester,SO,2014-15,F,Chattanooga,Southern,30,405,40,89,36,78,4,11,18,36,25,62,87,15,12,10,30,57,102
2566,Vaughn Gray,SR,2014-15,F,George Mason,A-10,28,411,37,115,18,47,19,68,9,23,16,21,37,10,13,3,11,33,102
2567,Rashard Kelly,FR,2014-15,F,Wichita State,MVC,35,483,38,77,34,68,4,9,22,42,45,56,101,14,13,11,36,44,102
2568,Patrick Kirksey,SO,2014-15,F,South Carolina State,MEAC,33,601,41,95,41,94,0,1,20,72,44,86,130,15,21,4,29,58,102
2569,Matt Klinewski,FR,2014-15,F,Lafayette,Patriot,33,296,40,86,40,85,0,1,22,35,27,32,59,6,8,12,19,48,102
2570,Josh Langford,SR,2014-15,G,Southeast Missouri State,OVC,22,322,37,92,33,79,4,13,24,34,15,25,40,6,9,6,26,54,102
2571,Marcus Lee,SO,2014-15,F,Kentucky,SEC,39,425,47,73,47,73,0,0,8,25,47,60,107,12,3,27,18,61,102
2572,Cameron Morse,FR,2014-15,G,Youngstown State,Horizon,17,265,31,73,18,35,13,38,27,36,4,17,21,22,13,1,11,19,102
2573,Dan Peera,SR,2014-15,G,Rice,CUSA,32,516,38,70,14,23,24,47,2,10,6,42,48,32,15,0,24,61,102
2574,Zach Rufer,JR,2014-15,G,Lafayette,Patriot,33,478,35,72,14,27,21,45,11,17,14,45,59,34,21,4,9,53,102
2575,Tom Schalk,SR,2014-15,F,William &amp; Mary,CAA,22,328,42,65,41,62,1,3,17,21,22,38,60,26,11,19,13,38,102
2576,Rocco Belcaster,SO,2014-15,F,Ball State,MAC,30,518,33,110,8,20,25,90,10,19,24,39,63,30,10,4,34,55,101
2577,Zach Gengler,SO,2014-15,G,Portland State,Big Sky,22,415,35,88,20,43,15,45,16,20,6,49,55,31,13,0,15,48,101
2578,Ryden Hines,SO,2014-15,F,Iona,MAAC,35,528,37,74,21,34,16,40,11,21,34,70,104,13,7,8,10,64,101
2579,Tim Jacobs,JR,2014-15,G,New Mexico,MWC,29,604,38,80,36,59,2,21,23,42,5,67,72,87,15,1,32,30,101
2580,Jermaine Lawrence,SO,2014-15,F,Manhattan,MAAC,21,276,41,99,39,83,2,16,17,34,11,25,36,2,9,16,30,34,101
2581,Kajon Mack,SO,2014-15,G,Tulane,AAC,31,439,39,93,31,58,8,35,15,20,8,64,72,22,15,6,30,44,101
2582,Nick Madray,SO,2014-15,F,Binghamton,AEC,13,286,39,104,25,59,14,45,9,10,9,36,45,4,3,11,15,21,101
2583,Evan Nolte,JR,2014-15,F,Virginia,ACC,33,590,35,99,14,23,21,76,10,16,8,43,51,23,19,5,15,46,101
2584,Tyler Rambo,JR,2014-15,F,Murray State,OVC,30,342,34,56,34,56,0,0,33,51,17,28,45,16,11,3,19,25,101
2585,C.J. Rivers,FR,2014-15,G,Drake,MVC,29,516,40,80,32,60,8,20,13,20,10,61,71,39,15,0,31,31,101
2586,Len Springs,SR,2014-15,F-C,Northern Arizona,Big Sky,38,621,41,88,41,88,0,0,19,33,86,99,185,7,8,72,37,79,101
2587,Zane Waterman,FR,2014-15,F,Manhattan,MAAC,28,232,32,87,14,35,18,52,19,29,19,23,42,4,6,7,15,59,101
2588,Devontae Watson,JR,2014-15,F-C,Temple,AAC,37,520,46,100,46,100,0,0,9,19,30,89,119,1,9,37,11,62,101
2589,Devon Begley,FR,2014-15,G,Northeastern,CAA,34,451,36,85,21,55,15,30,13,15,6,44,50,32,18,2,35,43,100
2590,Steven Davis,SO,2014-15,F,Wright State,Horizon,14,287,36,80,29,48,7,32,21,32,15,31,46,10,11,3,24,45,100
2591,Steven Jones,JR,2014-15,G,California-Riverside,Big West,18,455,35,83,26,57,9,26,21,29,8,34,42,57,14,1,38,51,100
2592,Silas Melson,FR,2014-15,G,Gonzaga,WCC,31,297,38,91,21,41,17,50,7,15,5,18,23,10,16,2,12,27,100
2593,Deontae North,FR,2014-15,G,Long Beach State,Big West,29,370,28,94,16,51,12,43,32,41,11,32,43,11,17,6,35,41,100
2594,Kenyatta Smith,SR,2014-15,C,Harvard,Ivy,23,292,41,72,41,72,0,0,18,28,15,43,58,5,6,27,20,42,100
2595,Mark Donnal,FR,2014-15,F,Michigan,Big Ten,29,309,35,67,28,48,7,19,22,31,26,36,62,4,4,10,9,45,99
2596,Caleb Donnelly,SR,2014-15,G,Northeastern,CAA,31,251,31,62,4,11,27,51,10,16,5,21,26,5,1,0,7,15,99
2597,Anthony Elechi,JR,2014-15,F-C,Morehead State,OVC,29,331,43,82,42,78,1,4,12,17,41,48,89,7,9,10,21,79,99
2598,Damien Goodwin,SO,2014-15,F,South Carolina Upstate,A-Sun,15,248,33,98,24,60,9,38,24,43,18,23,41,18,11,7,11,29,99
2599,Parker Jackson-Cartwright,FR,2014-15,G,Arizona,Pac-12,34,328,34,75,25,52,9,23,22,34,6,41,47,60,11,1,23,33,99
2600,Anthony Monaco,JR,2014-15,G,Northern Kentucky,A-Sun,22,425,32,95,12,36,20,59,15,17,4,48,52,21,10,3,30,52,99
2601,Kenneth Ogbe,SO,2014-15,G,Utah,Pac-12,22,288,30,70,15,30,15,40,24,35,4,27,31,12,5,1,18,24,99
2602,Satchel Pierce,FR,2014-15,F,Virginia Tech,ACC,31,428,39,81,39,81,0,0,21,33,35,39,74,14,6,23,39,84,99
2603,Ryan Rosburg,JR,2014-15,F,Missouri,SEC,30,501,42,84,42,84,0,0,15,45,37,41,78,8,6,18,19,56,99
2604,Xavier Adams,FR,2014-15,G,New Mexico,MWC,30,357,35,77,26,47,9,30,19,38,20,37,57,18,9,9,24,40,98
2605,Nathan Adrian,SO,2014-15,F,West Virginia,Big 12,35,539,35,114,24,52,11,62,17,26,51,37,88,34,28,14,26,83,98
2606,Skyler Flatten,FR,2014-15,G,South Dakota State,Summit,31,304,34,98,19,45,15,53,15,22,9,23,32,14,7,7,21,14,98
2607,B.J. Glasford,SO,2014-15,G,Stetson,A-Sun,30,492,35,121,21,64,14,57,14,23,4,37,41,33,15,2,31,50,98
2608,Josh James,SO,2014-15,F-C,IUPUI,Summit,31,396,38,80,38,80,0,0,22,32,29,58,87,12,9,16,32,63,98
2609,Aaron Korn,FR,2014-15,G,Lipscomb,A-Sun,30,442,31,90,15,39,16,51,20,27,8,66,74,18,8,1,20,37,98
2610,Nick Masterson,FR,2014-15,G,Kennesaw State,A-Sun,27,362,33,88,6,12,27,76,5,6,10,10,20,16,7,5,18,28,98
2611,Emanuel Pellot,JR,2014-15,F,Florida A&amp;M,MEAC,29,752,40,121,40,120,0,1,18,32,27,77,104,29,6,22,40,52,98
2612,Marvin Smith,SO,2014-15,G-F,North Carolina-Greensboro,Southern,21,379,34,117,19,72,15,45,15,26,26,33,59,9,8,4,15,54,98
2613,Nathan Taphorn,SO,2014-15,F,Northwestern,Big Ten,24,264,37,70,17,30,20,40,4,6,9,17,26,12,5,1,12,25,98
2614,Dockery Walker,SR,2014-15,F,Brown,Ivy,25,274,37,77,37,77,0,0,24,48,23,58,81,7,7,2,28,66,98
2615,Brandon Williams,SO,2014-15,F,Texas-Arlington,Sun Belt,31,382,39,70,39,69,0,1,20,38,29,63,92,6,11,30,14,40,98
2616,Marquel Willis,FR,2014-15,G-F,Morehead State,OVC,23,236,27,70,18,41,9,29,35,43,10,23,33,9,2,1,16,27,98
2617,Garet Beal,SO,2014-15,G-F,Maine,AEC,15,373,27,85,14,42,13,43,30,41,22,44,66,26,14,2,25,46,97
2618,Tashawn Desir,JR,2014-15,G,Florida International,CUSA,30,533,33,98,22,62,11,36,20,30,5,49,54,62,31,0,56,61,97
2619,Jeylani Dublin,SR,2014-15,F,Iona,MAAC,33,234,43,63,43,63,0,0,11,24,14,31,45,2,10,9,9,31,97
2620,Ajon Efferson,FR,2014-15,G,Cal State Northridge,Big West,26,291,35,96,12,36,23,60,4,7,2,13,15,16,4,0,16,20,97
2621,JoJo Fallas,SO,2014-15,G,Cornell,Ivy,30,358,33,92,7,16,26,76,5,7,5,24,29,16,13,1,14,30,97
2622,Darnell Foreman,FR,2014-15,G,Pennsylvania,Ivy,28,595,31,95,21,56,10,39,25,33,7,43,50,38,24,7,43,45,97
2623,Van Green,SR,2014-15,G,Rice,CUSA,32,452,36,99,26,64,10,35,15,24,15,54,69,14,14,3,32,37,97
2624,Isaiah Hobbs,FR,2014-15,G,Texas-Pan American,WAC,30,400,30,72,30,57,0,15,37,60,16,34,50,12,15,9,33,52,97
2625,Jaelyn Johnson-Coston,JR,2014-15,F,Weber State,Big Sky,30,304,36,71,36,70,0,1,25,40,20,36,56,8,12,6,27,40,97
2626,Griffin Kinney,FR,2014-15,F,Appalachian State,Sun Belt,28,421,38,95,38,94,0,1,21,35,22,53,75,12,4,3,42,71,97
2627,Trey McDonald,SR,2014-15,C,Ohio State,Big Ten,35,411,40,74,40,74,0,0,17,33,41,51,92,8,7,18,17,52,97
2628,Dinero Mercurius,FR,2014-15,G,South Florida,AAC,29,404,33,84,25,45,8,39,23,28,16,39,55,21,11,0,15,54,97
2629,Mike Miklusak,SO,2014-15,F,Western Illinois,Summit,15,316,33,94,19,44,14,50,17,21,12,48,60,14,7,3,15,34,97
2630,Stanford Robinson,SO,2014-15,G,Indiana,Big Ten,32,366,33,100,33,90,0,10,31,53,22,38,60,39,17,7,30,57,97
2631,Gabe Taylor,FR,2014-15,F,Portland,WCC,29,312,43,76,43,76,0,0,11,16,16,38,54,7,5,10,14,33,97
2632,Tucker Thompson,FR,2014-15,F,Western Carolina,Southern,32,471,36,77,36,76,0,1,25,38,38,53,91,17,14,13,20,47,97
2633,Christian Beyer,SR,2014-15,F,Virginia Tech,ACC,25,348,41,64,39,62,2,2,12,19,25,56,81,10,9,3,14,32,96
2634,Montana Byrd,FR,2014-15,G,Chicago State,WAC,28,328,31,103,6,22,25,81,9,12,10,26,36,8,11,2,19,30,96
2635,Devin Coleman,JR,2014-15,G,Temple,AAC,27,309,37,105,19,44,18,61,4,14,14,49,63,19,11,2,15,18,96
2636,Chaise Daniels,FR,2014-15,F,Quinnipiac,MAAC,30,431,42,89,42,89,0,0,12,20,31,49,80,7,7,29,28,74,96
2637,Demetrius Dyson,SO,2014-15,G,Massachusetts,A-10,29,310,31,97,17,40,14,57,20,35,26,32,58,14,9,3,11,31,96
2638,Keaton Moffitt,JR,2014-15,G,South Dakota State,Summit,29,457,31,71,29,64,2,7,32,46,21,55,76,41,23,4,24,43,96
2639,Luke Petrasek,SO,2014-15,F,Columbia,Ivy,19,322,35,87,20,41,15,46,11,20,16,40,56,18,2,12,17,40,96
2640,Keynan Pittman,JR,2014-15,F,Alcorn State,SWAC,30,433,42,75,42,75,0,0,12,33,27,48,75,3,9,12,20,75,96
2641,Jarelle Reischel,JR,2014-15,F,Rhode Island,A-10,32,290,37,78,31,55,6,23,16,33,25,36,61,12,9,2,22,44,96
2642,Shomari Triggs,JR,2014-15,G,Coppin State,MEAC,26,323,33,108,20,52,13,56,17,27,8,21,29,18,15,2,25,31,96
2643,Ethan Alvano,FR,2014-15,G,Eastern Michigan,MAC,28,405,20,85,12,44,8,41,47,56,8,31,39,50,23,2,24,23,95
2644,Jordan Baker,JR,2014-15,G,San Jose State,MWC,9,291,35,99,26,68,9,31,16,24,9,31,40,37,9,3,32,21,95
2645,T.J. Bell,SO,2014-15,F-C,Indiana State,MVC,31,388,34,68,34,68,0,0,27,42,26,54,80,10,7,15,29,74,95
2646,Willie Carmichael,FR,2014-15,F,Tennessee,SEC,32,475,40,77,40,77,0,0,15,24,44,31,75,11,6,13,29,101,95
2647,Eric Childress,SO,2014-15,G,California-Santa Barbara,Big West,33,602,30,83,23,57,7,26,28,41,14,63,77,70,23,3,42,62,95
2648,Qiydar Davis,JR,2014-15,G,Louisiana Tech,CUSA,29,292,38,88,34,74,4,14,15,26,29,35,64,5,13,6,17,49,95
2649,Javier Lacunza,JR,2014-15,F,Florida Atlantic,CUSA,28,358,32,81,20,32,12,49,19,26,15,35,50,3,5,1,15,42,95
2650,Ajak Magot,SR,2014-15,C,Idaho State,Big Sky,30,514,41,86,41,85,0,1,13,24,37,38,75,9,11,20,20,66,95
2651,Jaleni Neely,JR,2014-15,G,Northern Arizona,Big Sky,12,365,26,86,8,35,18,51,25,29,9,24,33,34,10,1,26,29,95
2652,Chazz Patterson,SO,2014-15,G,Saint Peter's,MAAC,33,556,25,80,8,25,17,55,28,38,7,55,62,24,22,3,27,53,95
2653,Devin Peterson,FR,2014-15,G,Western Carolina,Southern,32,413,34,86,26,61,8,25,19,32,11,22,33,29,16,4,27,46,95
2654,Marco Porcher Jimenez,SR,2014-15,G,Florida International,CUSA,28,380,34,93,10,21,24,72,3,5,3,32,35,11,6,1,16,27,95
2655,DaJuan Smith,JR,2014-15,G,California-Santa Barbara,Big West,30,419,38,84,36,77,2,7,17,29,14,47,61,45,12,3,24,28,95
2656,Austin Ajukwa,SO,2014-15,G,Clemson,ACC,30,363,35,98,24,58,11,40,13,20,17,38,55,12,19,5,20,46,94
2657,Joe Crisman,SR,2014-15,G,Loyola (IL),MVC,37,626,34,78,26,53,8,25,18,32,16,71,87,49,32,7,39,31,94
2658,Nathan Ekwu,FR,2014-15,F,Davidson,A-10,31,364,38,85,35,77,3,8,15,37,28,68,96,11,13,16,28,78,94
2659,Ben Emelogu,SO,2014-15,G,Southern Methodist,AAC,34,516,31,112,15,52,16,60,16,22,7,55,62,34,20,7,29,45,94
2660,Davon Hayes,FR,2014-15,G-F,Southern Mississippi,CUSA,22,307,29,79,15,41,14,38,22,33,5,25,30,16,8,2,28,25,94
2661,Alan Herndon,FR,2014-15,F,Wyoming,MWC,31,477,37,78,33,55,4,23,16,27,15,54,69,16,7,12,18,29,94
2662,Joel James,JR,2014-15,F,North Carolina,ACC,38,382,41,91,41,91,0,0,12,18,25,47,72,6,4,9,20,52,94
2663,John Marshall,SO,2014-15,G,Southern Utah,Big Sky,29,447,28,65,27,54,1,11,37,50,6,25,31,54,14,3,34,59,94
2664,J.J. N'Ganga,JR,2014-15,C,New Mexico,MWC,29,344,36,61,36,61,0,0,22,36,18,30,48,6,1,5,31,54,94
2665,Frank Rogers,JR,2014-15,F,San Jose State,MWC,9,217,36,84,27,59,9,25,13,24,17,38,55,10,5,6,20,33,94
2666,Bryson Scott,SO,2014-15,G,Purdue,Big Ten,25,268,30,78,29,70,1,8,33,46,7,33,40,29,18,3,27,32,94
2667,Jeremy Verhagen,FR,2014-15,F,Northern Colorado,Big Sky,30,417,41,69,41,64,0,5,12,23,34,27,61,10,7,9,23,61,94
2668,Taylor Abt,SR,2014-15,F,Holy Cross,Patriot,30,460,40,70,40,66,0,4,13,33,46,40,86,4,9,23,11,78,93
2669,A.J. Astroth,SO,2014-15,G,Towson,CAA,28,446,31,79,21,43,10,36,21,38,30,45,75,9,13,2,19,49,93
2670,Cliff Cornish,SO,2014-15,F,Morgan State,MEAC,30,403,34,91,34,90,0,1,25,40,37,51,88,11,7,11,22,64,93
2671,Jaleel Cousins,JR,2014-15,C,South Florida,AAC,32,367,32,68,32,68,0,0,29,67,32,51,83,3,4,23,37,77,93
2672,Denzel Gregg,SO,2014-15,G-F,St. Bonaventure,A-10,25,434,40,97,40,91,0,6,13,30,34,46,80,23,17,23,34,56,93
2673,Michael Humphrey,FR,2014-15,F,Stanford,Pac-12,30,338,41,74,41,72,0,2,11,22,35,46,81,13,11,23,15,76,93
2674,Raheem Johnson,JR,2014-15,F,Buffalo,MAC,33,388,36,67,36,67,0,0,21,34,35,47,82,3,11,37,24,78,93
2675,Justin McCloud,JR,2014-15,G,Illinois State,MVC,30,351,30,81,1,6,29,75,4,5,3,28,31,16,8,1,10,15,93
2676,Eric McKnight,SR,2014-15,F,Long Beach State,Big West,32,463,41,69,41,69,0,0,11,28,26,55,81,10,9,20,23,61,93
2677,D'Juan Miller,JR,2014-15,G,Illinois-Chicago,Horizon,20,514,35,115,28,87,7,28,16,27,13,40,53,80,22,2,43,40,93
2678,JaQuel Richmond,FR,2014-15,G,Middle Tennessee,CUSA,27,451,32,108,17,71,15,37,14,17,3,32,35,60,12,0,45,42,93
2679,Kyle Sikora,JR,2014-15,C,Stetson,A-Sun,28,505,38,72,38,72,0,0,17,34,22,80,102,4,7,15,29,52,93
2680,Shirmane Thomas,SO,2014-15,G,Tennessee Tech,OVC,27,529,34,111,34,87,0,24,25,44,8,47,55,66,19,14,58,56,93
2681,Manuale Watkins,SO,2014-15,G,Arkansas,SEC,36,502,38,68,38,61,0,7,17,24,17,56,73,39,37,0,28,54,93
2682,Jack Williams,FR,2014-15,F,Long Beach State,Big West,32,415,30,93,17,56,13,37,20,28,35,43,78,14,8,4,25,44,93
2683,Steven Wronkoski,SO,2014-15,G,Louisiana-Lafayette,Sun Belt,36,418,31,75,13,22,18,53,13,19,18,43,61,26,7,1,17,31,93
2684,Willie Atwood,JR,2014-15,F,Arizona State,Pac-12,31,359,25,73,14,42,11,31,31,50,20,34,54,11,5,2,16,51,92
2685,Josh Davenport,SO,2014-15,F,Winthrop,Big South,32,437,33,98,31,84,2,14,24,37,20,42,62,34,27,4,30,39,92
2686,Elliott Eliason,SR,2014-15,C,Minnesota,Big Ten,31,346,37,59,37,59,0,0,18,40,42,50,92,15,9,16,13,50,92
2687,Andrew Hampton,SO,2014-15,F,Morgan State,MEAC,14,202,33,76,10,23,23,53,3,5,4,17,21,5,6,1,2,19,92
2688,Jalen Little,JR,2014-15,G,Abilene Christian,Southland,31,803,27,96,15,58,12,38,26,33,6,59,65,112,29,0,50,63,92
2689,Geno Luzcando,FR,2014-15,G,Idaho State,Big Sky,30,469,32,88,20,45,12,43,16,33,6,39,45,44,36,1,42,66,92
2690,Mack Mercer,FR,2014-15,F,Belmont,OVC,28,186,34,68,33,57,1,11,23,31,14,25,39,13,1,12,16,38,92
2691,Jamar Redmond,FR,2014-15,G,Morgan State,MEAC,26,244,31,97,11,28,20,69,10,21,13,11,24,6,6,1,11,33,92
2692,Nick Shepherd,SR,2014-15,F,Texas Southern,SWAC,34,558,31,62,31,62,0,0,30,54,43,41,84,7,8,56,14,86,92
2693,Basil Smotherman,SO,2014-15,F,Purdue,Big Ten,34,438,39,83,35,62,4,21,10,17,20,41,61,31,17,6,17,46,92
2694,Tyrell Sturdivant,FR,2014-15,F,Stony Brook,AEC,33,376,35,86,35,86,0,0,22,44,46,64,110,10,13,11,19,40,92
2695,Drew Urquhart,FR,2014-15,F,Vermont,AEC,30,244,34,81,33,73,1,8,23,32,16,38,54,8,2,4,20,43,92
2696,Daniel Amigo,FR,2014-15,C,Denver,Summit,15,234,36,78,36,76,0,2,19,26,9,13,22,17,8,11,27,57,91
2697,Ivan Benkovic,SO,2014-15,G,Charlotte,CUSA,27,277,28,73,3,6,25,67,10,13,7,20,27,12,5,1,12,40,91
2698,Nick Griffin,SO,2014-15,G,George Washington,A-10,35,276,31,95,7,29,24,66,5,6,8,22,30,7,5,2,11,22,91
2699,Marcus Merriweather,SO,2014-15,G,Alabama A&amp;M,SWAC,26,253,27,86,15,52,12,34,25,36,5,16,21,17,4,1,23,25,91
2700,LaTre'e Russell,SR,2014-15,F,Norfolk State,MEAC,30,480,33,80,33,78,0,2,25,33,24,41,65,20,10,12,42,83,91
2701,Mike Samuels,JR,2014-15,C,Eastern Michigan,MAC,34,385,32,60,32,60,0,0,27,42,42,79,121,7,14,15,27,96,91
2702,Ian Theisen,FR,2014-15,F,South Dakota State,Summit,35,300,29,55,25,47,4,8,29,41,21,44,65,8,7,9,18,76,91
2703,Austin Tilghman,FR,2014-15,G,Monmouth,MAAC,33,495,24,67,18,51,6,16,37,60,11,56,67,53,17,1,49,38,91
2704,Emmanuel Toney,SO,2014-15,G,Texas A&amp;M-Corpus Christi,Southland,34,656,31,71,26,50,5,21,24,32,30,38,68,27,32,2,24,58,91
2705,Quevyn Winters,JR,2014-15,G,Washington,Pac-12,27,299,33,111,16,42,17,69,8,10,10,26,36,19,8,1,23,27,91
2706,Zach Brown,FR,2014-15,F,Wichita State,MVC,27,284,29,56,18,30,11,26,21,29,18,19,37,7,9,10,12,29,90
2707,Paschal Chukwu,FR,2014-15,C,Providence,Big East,34,335,33,50,33,50,0,0,24,40,33,50,83,5,9,23,19,63,90
2708,Chauncey Collins,FR,2014-15,G,Texas Christian,Big 12,26,242,25,82,8,20,17,62,23,32,5,16,21,23,4,1,16,32,90
2709,Jordan Dickerson,JR,2014-15,C,Penn State,Big Ten,34,582,33,68,33,67,0,1,24,40,42,71,113,9,10,53,23,105,90
2710,Jamal Ferguson,SO,2014-15,G,North Carolina Central,MEAC,33,283,34,74,34,72,0,2,22,33,7,24,31,15,10,3,22,30,90
2711,Junior Fortunat,SR,2014-15,F-C,Rider,MAAC,30,297,35,58,35,58,0,0,20,53,23,24,47,3,4,16,20,49,90
2712,Lyonell Gaines,JR,2014-15,F,Morehead State,OVC,15,313,40,72,39,65,1,7,9,19,28,35,63,12,2,3,6,22,90
2713,Chandler Hutchison,FR,2014-15,G,Boise State,MWC,29,358,31,87,27,73,4,14,24,37,22,35,57,23,14,4,15,42,90
2714,Keenan Palmore,JR,2014-15,G,Old Dominion,CUSA,35,385,36,77,36,73,0,4,18,31,9,43,52,35,13,0,34,57,90
2715,Darius Stokes,SR,2014-15,F,Fairleigh Dickinson,NEC,29,548,40,78,40,78,0,0,10,31,36,60,96,5,11,34,12,90,90
2716,Nemanja Zarkovic,FR,2014-15,G,Fordham,A-10,27,366,32,87,14,35,18,52,8,15,9,14,23,29,8,1,33,40,90
2717,Jawad Adekoya,JR,2014-15,G-F,Chicago State,WAC,19,235,25,89,8,28,17,61,22,28,5,20,25,7,14,2,12,24,89
2718,Dalan Ancrum,FR,2014-15,G-F,Western Illinois,Summit,25,286,31,92,18,58,13,34,14,21,12,27,39,8,5,7,20,35,89
2719,Greg Andrade,SR,2014-15,G,Central Connecticut State,NEC,30,553,29,77,18,43,11,34,20,32,20,59,79,17,12,13,17,33,89
2720,Dreon Barlett,JR,2014-15,G,Sacramento State,Big Sky,33,333,30,59,11,18,19,41,10,15,6,37,43,11,2,2,12,33,89
2721,Dimitrije Cabarkapa,SO,2014-15,F,James Madison,CAA,19,185,31,75,15,35,16,40,11,11,15,26,41,3,2,0,6,19,89
2722,Javonte Douglas,JR,2014-15,F,Old Dominion,CUSA,25,255,33,74,31,67,2,7,21,38,18,48,66,19,5,5,17,36,89
2723,Michel Enanga,JR,2014-15,F,Coastal Carolina,Big South,34,532,31,79,20,46,11,33,16,31,43,80,123,31,19,8,33,61,89
2724,Tim Gill,JR,2014-15,F-C,Jacksonville,A-Sun,23,369,28,74,28,73,0,1,33,55,36,27,63,5,5,5,18,51,89
2725,Demetrius Houston,FR,2014-15,F,Mississippi State,SEC,29,378,31,102,28,89,3,13,24,45,16,50,66,11,15,5,35,42,89
2726,Haralds Karlis,SR,2014-15,G,Seton Hall,Big East,27,335,28,61,11,17,17,44,16,24,9,9,18,13,8,1,24,31,89
2727,Andrew McAuliffe,SO,2014-15,F,Davidson,A-10,32,404,40,70,40,70,0,0,9,23,31,61,92,12,12,7,14,54,89
2728,Tory Miller,FR,2014-15,F,Colorado,Pac-12,30,258,31,66,31,66,0,0,27,36,20,45,65,4,4,5,25,41,89
2729,Wyatt Sikora,FR,2014-15,F-C,Stetson,A-Sun,31,365,33,72,31,58,2,14,21,32,23,41,64,5,2,21,15,29,89
2730,Kerwin Smith,FR,2014-15,F,Grand Canyon,WAC,32,400,36,75,36,75,0,0,17,35,23,50,73,0,5,15,29,74,89
2731,Antwan Space,JR,2014-15,F,Texas A&amp;M,SEC,21,261,33,71,29,54,4,17,19,32,19,41,60,6,4,9,18,37,89
2732,Aaron Thomas,JR,2014-15,G,Florida State,ACC,6,170,32,70,28,53,4,17,21,29,0,21,21,13,8,0,16,14,89
2733,Davonte Fitzgerald,SO,2014-15,F,Texas A&amp;M,SEC,25,240,29,89,13,36,16,53,14,21,11,29,40,4,3,5,16,22,88
2734,Dustin Hobaugh,JR,2014-15,G,North Dakota,Big Sky,30,438,26,67,14,33,12,34,24,35,26,46,72,11,14,4,13,46,88
2735,Mangok Mathiang,SO,2014-15,F-C,Louisville,ACC,34,635,31,80,31,80,0,0,26,54,80,79,159,16,19,46,26,82,88
2736,Juwan Parker,SO,2014-15,G,Georgia,SEC,18,364,28,73,23,49,5,24,27,36,16,51,67,15,11,2,21,31,88
2737,Deion Taylor,JR,2014-15,F,Richmond,A-10,35,822,27,89,21,48,6,41,28,60,33,99,132,47,35,25,27,103,88
2738,Jarid Watson,SR,2014-15,C,Virginia Military Institute,Southern,30,372,38,69,38,69,0,0,12,29,43,48,91,14,8,26,13,58,88
2739,Sam Downey,SO,2014-15,F,Yale,Ivy,25,276,38,79,38,79,0,0,11,16,23,25,48,1,9,5,11,34,87
2740,Billy Jackson,JR,2014-15,G,Mississippi Valley State,SWAC,32,441,28,101,22,63,6,38,25,41,16,22,38,24,17,1,36,45,87
2741,Nevin Johnson,JR,2014-15,G-F,Texas Southern,SWAC,32,384,24,72,14,32,10,40,29,38,17,39,56,21,8,2,21,36,87
2742,Jay Knuth,FR,2014-15,F,Loyola (IL),MVC,32,289,23,63,12,37,11,26,30,34,13,19,32,8,7,1,19,32,87
2743,Cameron Monroe,SR,2014-15,G,Southern,SWAC,32,334,29,76,23,50,6,26,23,33,10,35,45,13,19,5,34,51,87
2744,Pat Moore,SR,2014-15,G,Colgate,Patriot,25,331,29,77,3,9,26,68,3,6,3,18,21,19,3,1,11,17,87
2745,Marshall Plumlee,JR,2014-15,C,Duke,ACC,39,375,32,42,31,41,1,1,22,31,39,53,92,12,8,22,14,58,87
2746,Grant Prusator,SO,2014-15,G,Indiana State,MVC,29,243,28,65,3,7,25,58,6,9,4,15,19,6,7,0,6,23,87
2747,Chris Sarbaugh,JR,2014-15,G,San Diego,WCC,27,413,30,72,20,48,10,24,17,21,10,43,53,28,14,2,21,44,87
2748,Hooper Vint,JR,2014-15,C,Texas-El Paso,CUSA,30,364,38,75,33,54,5,21,6,19,23,40,63,13,0,15,11,51,87
2749,Devin Berry,SO,2014-15,F,Arkansas-Pine Bluff,SWAC,31,452,35,74,35,74,0,0,16,29,47,38,85,7,10,16,16,80,86
2750,Jeffrey Carroll,FR,2014-15,G-F,Oklahoma State,Big 12,22,250,32,82,15,25,17,57,5,7,9,31,40,7,5,5,6,16,86
2751,Arthur Edwards,JR,2014-15,G,New Mexico,MWC,22,263,26,72,18,36,8,36,26,39,12,32,44,17,11,4,31,37,86
2752,Kurt Hall,FR,2014-15,G-F,Toledo,MAC,32,208,25,53,24,51,1,2,35,42,27,21,48,4,2,0,14,29,86
2753,Carlton Lowe,SO,2014-15,G,Grambling,SWAC,27,198,25,64,14,33,11,31,25,41,17,23,40,3,1,2,17,36,86
2754,Will Magarity,SO,2014-15,F,Boston College,ACC,22,345,31,78,22,49,9,29,15,26,26,36,62,12,8,9,22,55,86
2755,Deshaun Morman,FR,2014-15,G,Cincinnati,AAC,24,241,28,74,24,61,4,13,26,40,10,11,21,17,12,2,20,36,86
2756,Pete Rakocevic,SR,2014-15,C,Northern Illinois,MAC,23,348,34,81,34,71,0,10,18,23,18,51,69,12,5,12,25,48,86
2757,Mason Ramsay,FR,2014-15,F,Tennessee Tech,OVC,26,242,32,71,23,38,9,33,13,19,25,35,60,10,8,1,13,48,86
2758,Jordan Robinson,FR,2014-15,F,Duquesne,A-10,22,217,30,48,30,48,0,0,26,46,18,29,47,2,0,12,18,33,86
2759,Warren Sledge,SO,2014-15,G,Citadel,Southern,28,594,27,73,16,45,11,28,21,29,8,35,43,85,17,3,40,37,86
2760,Cody Stetler,SO,2014-15,C,Houston Baptist,Southland,24,235,31,68,30,62,1,6,23,33,19,34,53,13,5,16,21,44,86
2761,Dakarai Allen,SO,2014-15,G,San Diego State,MWC,33,396,30,73,28,63,2,10,23,34,19,37,56,14,19,8,21,58,85
2762,Davon Bell,FR,2014-15,G,Presbyterian,Big South,29,597,29,88,27,71,2,17,25,40,12,49,61,83,23,1,54,51,85
2763,Brynton Lemar,SO,2014-15,G,California-Davis,Big West,32,436,25,77,13,44,12,33,23,36,4,35,39,29,10,1,42,55,85
2764,Lourawls Nairn,FR,2014-15,G,Michigan State,Big Ten,39,758,28,88,25,78,3,10,26,48,6,56,62,94,11,1,36,83,85
2765,Zaynah Robinson,FR,2014-15,G,Norfolk State,MEAC,33,426,35,88,29,57,6,31,9,16,0,39,39,39,19,0,25,28,85
2766,Shawn Roundtree,FR,2014-15,G,Missouri State,MVC,31,536,31,107,24,63,7,44,16,27,4,42,46,44,9,0,40,39,85
2767,Tate Stensgaard,JR,2014-15,F,Western Illinois,Summit,20,423,32,57,32,56,0,1,21,31,20,70,90,17,9,6,20,68,85
2768,Gary Akbar,JR,2014-15,G-F,Kent State,MAC,32,429,31,68,31,68,0,0,22,50,34,50,84,27,13,8,38,68,84
2769,Robert Boezeman,FR,2014-15,F,California-Riverside,Big West,30,342,31,60,24,48,7,12,15,22,24,27,51,4,5,5,18,49,84
2770,Kion Brown,JR,2014-15,F,Radford,Big South,33,360,29,66,29,66,0,0,26,40,19,40,59,7,3,6,33,47,84
2771,Carlton Brundidge,JR,2014-15,G,Detroit Mercy,Horizon,33,353,31,83,26,66,5,17,17,27,14,28,42,33,29,0,19,28,84
2772,Iba Camara,FR,2014-15,F,New Hampshire,AEC,27,285,35,78,35,78,0,0,14,33,33,74,107,10,5,5,27,69,84
2773,Tomasz Gielo,SR,2014-15,F,Liberty,Big South,7,216,24,60,13,33,11,27,25,31,7,37,44,9,6,1,16,14,84
2774,Chris Kemp,SR,2014-15,F,Montana,Big Sky,28,249,35,61,35,61,0,0,14,28,19,29,48,2,3,1,15,43,84
2775,Kendall Knorr,JR,2014-15,G,Navy,Patriot,20,433,27,69,17,36,10,33,20,24,12,50,62,31,10,0,11,29,84
2776,Joseph Lopez,FR,2014-15,F,Winthrop,Big South,28,278,35,59,35,58,0,1,14,25,23,46,69,5,8,4,19,37,84
2777,Alex Ramon,SO,2014-15,G,Colgate,Patriot,31,388,31,52,19,31,12,21,10,15,9,33,42,25,18,0,21,49,84
2778,Christian Albright,FR,2014-15,F,Abilene Christian,Southland,20,269,36,84,36,82,0,2,11,17,21,44,65,20,6,9,26,37,83
2779,Daniel Camps,SO,2014-15,F,Northern Kentucky,A-Sun,18,214,34,55,32,49,2,6,13,22,16,32,48,12,10,0,11,24,83
2780,Sami Eleraky,SO,2014-15,C,Pacific,WCC,23,401,30,62,30,62,0,0,23,62,33,59,92,12,2,25,28,53,83
2781,Ben Grace,SO,2014-15,G,Maryland-Baltimore County,AEC,23,397,24,66,4,11,20,55,15,16,3,28,31,10,9,0,12,20,83
2782,Kodi Justice,FR,2014-15,G,Arizona State,Pac-12,18,229,28,66,11,29,17,37,10,12,6,16,22,28,5,2,19,22,83
2783,Zach Moer,JR,2014-15,C,Air Force,MWC,30,259,33,65,28,55,5,10,12,15,18,30,48,12,7,16,28,53,83
2784,Luke Morrison,FR,2014-15,F,Army,Patriot,19,188,31,76,15,27,16,49,5,12,10,29,39,11,6,5,13,28,83
2785,Curtis Oakley,JR,2014-15,G,Bryant,NEC,27,276,30,79,17,41,13,38,10,15,6,31,37,12,6,0,14,33,83
2786,Ryan Pierson,SR,2014-15,F-C,Vermont,AEC,26,267,32,72,32,71,0,1,19,22,18,29,47,9,2,3,21,31,83
2787,Rashaun Stimage,JR,2014-15,F,DePaul,Big East,17,264,31,65,30,59,1,6,20,38,26,27,53,0,8,22,7,36,83
2788,Lance Whitaker,FR,2014-15,G-F,Illinois-Chicago,Horizon,29,534,28,83,22,57,6,26,21,41,16,42,58,31,16,2,24,53,83
2789,Isaac Banks,FR,2014-15,F,East Tennessee State,Southern,28,527,36,69,35,67,1,2,9,19,51,87,138,19,10,27,18,80,82
2790,Frank Bartley,SO,2014-15,G,Brigham Young,WCC,33,307,24,63,17,39,7,24,27,44,10,49,59,39,15,11,21,23,82
2791,Jordan Butler,FR,2014-15,F,Norfolk State,MEAC,33,454,33,68,33,68,0,0,16,33,37,67,104,19,11,36,29,41,82
2792,Travis Julien,JR,2014-15,F,Nicholls State,Southland,27,349,34,65,34,63,0,2,14,39,27,42,69,14,9,18,28,70,82
2793,Wayne Langston,JR,2014-15,F,Murray State,OVC,33,404,30,50,30,50,0,0,22,42,33,71,104,6,8,10,21,62,82
2794,Aleksej Rostov,JR,2014-15,F,Western Kentucky,CUSA,32,327,31,82,26,61,5,21,15,21,29,49,78,12,4,7,25,48,82
2795,Devon Scott,JR,2014-15,F-C,Dayton,A-10,9,249,28,44,28,44,0,0,26,42,21,46,67,7,4,4,15,20,82
2796,Dave Sobolewski,SR,2014-15,G,Northwestern,Big Ten,31,337,22,56,6,11,16,45,22,26,3,21,24,22,9,1,9,43,82
2797,Joe Boyd,SO,2014-15,F,Cal State Fullerton,Big West,31,525,29,74,29,74,0,0,23,27,36,79,115,12,3,6,25,65,81
2798,Darian Harris,FR,2014-15,G,Oral Roberts,Summit,32,436,25,83,3,10,22,73,9,17,14,48,62,26,18,6,17,36,81
2799,Sekou Harris,JR,2014-15,G,South Dakota,Summit,22,318,30,77,21,51,9,26,12,17,6,28,34,34,10,2,30,26,81
2800,Anthony Johnson,SO,2014-15,G,Northern Colorado,Big Sky,23,191,28,51,12,21,16,30,9,12,5,15,20,10,7,1,5,24,81
2801,Justin McKie,SO,2014-15,G,South Carolina,SEC,25,282,26,67,15,31,11,36,18,23,11,33,44,8,9,3,11,20,81
2802,Emerson Murray,JR,2014-15,G,Seattle,WAC,33,873,25,64,16,35,9,29,22,42,11,104,115,101,42,1,57,70,81
2803,Filip Nowicki,FR,2014-15,C,Sacred Heart,NEC,29,322,38,69,38,69,0,0,5,8,33,53,86,4,2,12,22,48,81
2804,Terrance O'Donohue,SO,2014-15,F,College of Charleston,CAA,30,381,31,71,27,61,4,10,15,26,29,29,58,5,17,12,22,68,81
2805,D.J.  Peterson,SR,2014-15,G,La Salle,A-10,30,709,29,72,18,27,11,45,12,15,17,71,88,49,25,5,23,52,81
2806,Xzavier Taylor,SO,2014-15,F-C,Bradley,MVC,29,287,31,70,31,70,0,0,19,34,30,23,53,3,5,8,23,75,81
2807,Jonathan Williams,FR,2014-15,G,Virginia Commonwealth,A-10,35,361,28,80,28,77,0,3,25,51,2,18,20,46,23,1,29,41,81
2808,Devonta Abron,JR,2014-15,F,Texas Christian,Big 12,28,211,24,46,24,46,0,0,32,61,32,28,60,8,4,4,11,48,80
2809,Robbie Berwick,FR,2014-15,G,Florida State,ACC,33,361,26,89,7,26,19,63,9,17,9,25,34,22,12,1,18,42,80
2810,B.J. Gladden,FR,2014-15,F,Akron,MAC,28,272,28,70,24,57,4,13,20,36,19,25,44,12,7,4,24,28,80
2811,Tre Harris,FR,2014-15,G,Kansas State,Big 12,21,211,28,56,8,12,20,44,4,8,3,15,18,11,5,0,7,24,80
2812,Aaron Jackson,FR,2014-15,G,Akron,MAC,29,269,28,85,11,30,17,55,7,19,14,30,44,5,8,1,15,35,80
2813,Josh Jones,SO,2014-15,G,Richmond,A-10,34,339,27,71,11,19,16,52,10,16,13,23,36,21,4,3,10,36,80
2814,Mo Williams,SR,2014-15,G,Army,Patriot,30,616,24,75,12,30,12,45,20,33,8,15,23,22,23,4,18,63,80
2815,Michael Zangari,JR,2014-15,F,East Carolina,AAC,31,490,32,82,31,71,1,11,15,25,40,61,101,18,10,15,19,68,80
2816,Zach Coleman,FR,2014-15,F,Massachusetts,A-10,32,329,27,71,16,32,11,39,14,18,18,44,62,10,7,9,18,46,79
2817,Assane Diop,SO,2014-15,F-C,Austin Peay,OVC,27,290,27,91,16,42,11,49,14,19,12,35,47,7,3,12,19,43,79
2818,Jermaine Edmonds,SO,2014-15,G-F,Montana,Big Sky,9,225,28,68,15,27,13,41,10,15,1,28,29,12,10,3,9,17,79
2819,Oliver Ellison,JR,2014-15,C,Howard,MEAC,30,565,34,55,34,55,0,0,11,30,37,69,106,3,9,35,23,67,79
2820,Alex Etherington,FR,2014-15,G-F,Indiana State,MVC,26,383,27,75,11,20,16,55,9,15,7,29,36,14,16,1,21,51,79
2821,Jure Gunjima,JR,2014-15,G,IPFW,Summit,30,243,33,71,25,39,8,32,5,7,10,40,50,13,5,3,14,20,79
2822,Rodney Hawkins,FR,2014-15,F,Saint Peter's,MAAC,22,223,29,72,26,63,3,9,18,31,15,24,39,2,2,9,5,42,79
2823,Scott King,JR,2014-15,F,Stony Brook,AEC,26,206,24,70,8,18,16,52,15,22,13,17,30,10,4,4,12,20,79
2824,Jordy Kuiper,SO,2014-15,F,North Carolina-Greensboro,Southern,24,339,32,55,32,55,0,0,15,21,30,33,63,9,9,4,13,59,79
2825,Desmond Lee,JR,2014-15,G,North Carolina State,ACC,28,217,20,57,19,46,1,11,38,47,12,17,29,13,9,0,16,31,79
2826,Maverick Morgan,SO,2014-15,C,Illinois,Big Ten,31,275,30,66,30,66,0,0,19,23,26,22,48,3,3,11,14,33,79
2827,Paulin Mpawe,JR,2014-15,F,Idaho,Big Sky,30,411,33,72,33,72,0,0,13,32,39,48,87,7,6,12,20,54,79
2828,Hudson Price,SO,2014-15,G,Texas Christian,Big 12,28,256,27,67,14,34,13,33,12,19,9,23,32,20,2,2,19,31,79
2829,DaRohn Scott,FR,2014-15,F,Central Michigan,MAC,32,276,30,53,30,52,0,1,19,40,28,33,61,1,6,28,14,56,79
2830,Gabe Snider,JR,2014-15,G,Illinois-Chicago,Horizon,24,222,27,81,4,21,23,60,2,4,7,13,20,11,6,0,4,19,79
2831,Lucas Stivrins,JR,2014-15,F-C,Nevada,MWC,29,327,27,55,26,54,1,1,24,38,32,49,81,7,2,7,19,49,79
2832,Earl Watson,JR,2014-15,C,Rhode Island,A-10,31,307,31,54,31,54,0,0,17,34,32,50,82,6,3,27,15,55,79
2833,Kalif Wright,JR,2014-15,F,Miami (OH),MAC,27,256,32,78,32,78,0,0,15,25,11,35,46,0,3,3,18,49,79
2834,Jamar Akoh,FR,2014-15,F,Cal State Fullerton,Big West,30,431,29,74,27,67,2,7,18,38,24,51,75,12,13,6,24,45,78
2835,Michal Cekovsky,FR,2014-15,F,Maryland,Big Ten,30,379,36,69,36,69,0,0,6,21,27,47,74,4,4,19,16,62,78
2836,Anton Gill,SO,2014-15,G,Louisville,ACC,31,292,30,85,19,42,11,43,7,19,2,23,25,17,15,4,20,32,78
2837,Jonathan Graham,SR,2014-15,F,Maryland,Big Ten,34,383,32,60,32,60,0,0,14,27,36,58,94,5,3,8,16,52,78
2838,Fred Iruafemi,FR,2014-15,F,Virginia Military Institute,Southern,28,343,31,68,31,68,0,0,16,25,23,47,70,21,18,23,12,52,78
2839,D'Andre Johnson,SO,2014-15,G,Florida Atlantic,CUSA,21,273,29,69,19,41,10,28,10,17,4,27,31,22,12,0,22,27,78
2840,DeAndre McIntyre,SR,2014-15,G,Arkansas-Pine Bluff,SWAC,27,479,25,71,15,41,10,30,18,30,15,43,58,16,21,6,36,49,78
2841,Rylan Murry,FR,2014-15,F,Nebraska-Omaha,Summit,25,251,26,58,12,19,14,39,12,18,12,12,24,8,3,3,9,39,78
2842,Jimmy Paige,FR,2014-15,G,Siena,MAAC,29,314,24,50,24,42,0,8,30,40,35,33,68,7,6,5,12,28,78
2843,Taylor Perry,JR,2014-15,G,Western Michigan,MAC,32,417,29,61,18,36,11,25,9,17,24,45,69,31,15,5,22,30,78
2844,Myles Taylor,SR,2014-15,F,Tennessee-Martin,OVC,7,142,25,34,25,33,0,1,28,35,12,30,42,7,3,3,12,23,78
2845,Charles Waters,JR,2014-15,F,Arkansas State,Sun Belt,25,323,31,72,31,70,0,2,16,21,32,52,84,3,14,18,14,58,78
2846,Taelin Webb,FR,2014-15,G,Cal State Northridge,Big West,30,457,27,86,19,64,8,22,16,25,6,24,30,52,12,6,43,40,78
2847,Kyle Williams,FR,2014-15,F,Grambling,SWAC,29,557,31,69,31,69,0,0,16,32,34,66,100,7,5,10,28,59,78
2848,Tyler Williams,FR,2014-15,G,Brown,Ivy,30,414,27,94,17,42,10,52,14,21,4,20,24,33,7,0,33,50,78
2849,Riley Barker,SR,2014-15,C,Portland,WCC,16,302,30,65,30,63,0,2,17,27,38,43,81,8,14,15,16,38,77
2850,Christian Burton,SR,2014-15,G,Virginia Military Institute,Southern,28,265,25,74,9,21,16,53,11,17,14,21,35,23,17,0,21,31,77
2851,Alex Fountain,SO,2014-15,F,Houston Baptist,Southland,22,299,30,79,25,62,5,17,12,15,21,23,44,11,6,1,13,25,77
2852,Riley Payne,FR,2014-15,F,Abilene Christian,Southland,30,438,33,72,33,72,0,0,11,28,26,28,54,8,4,1,12,65,77
2853,Roosevelt Scott,JR,2014-15,G-F,Arizona State,Pac-12,20,243,27,61,24,45,3,16,20,31,9,33,42,11,12,0,23,32,77
2854,Darnell Taylor,JR,2014-15,G,Fresno State,MWC,32,485,31,76,24,48,7,28,8,19,18,54,72,43,19,2,21,48,77
2855,Donte Thomas,FR,2014-15,F,Bradley,MVC,31,369,30,91,21,52,9,39,8,20,20,56,76,19,9,7,32,53,77
2856,Nate Wells,JR,2014-15,C,Bradley,MVC,26,301,34,78,31,64,3,14,6,10,16,24,40,8,7,19,11,39,77
2857,Tyler Wideman,FR,2014-15,F,Butler,Big East,34,371,30,56,30,56,0,0,17,41,32,57,89,15,9,15,22,62,77
2858,Willem Brandwijk,FR,2014-15,F,Siena,MAAC,31,396,27,65,18,45,9,20,13,25,26,55,81,12,21,14,22,55,76
2859,Cameron Jackson,FR,2014-15,F,Wofford,Southern,32,265,30,53,30,53,0,0,16,21,15,37,52,7,11,12,11,48,76
2860,Japhet Kadji,FR,2014-15,F,Wagner,NEC,24,255,29,61,22,44,7,17,11,16,19,41,60,5,7,6,9,48,76
2861,Ibn Muhammad,JR,2014-15,G,Iona,MAAC,35,637,25,57,12,22,13,35,13,20,3,45,48,65,16,0,29,49,76
2862,Angel Nunez,SR,2014-15,F,Gonzaga,WCC,28,176,27,46,22,31,5,15,17,26,13,39,52,15,3,8,15,26,76
2863,Malik Pugh,FR,2014-15,G,North Carolina-Wilmington,CAA,27,251,31,69,27,49,4,20,10,26,5,10,15,31,11,0,29,17,76
2864,Charles Standifer,SR,2014-15,G,California-Riverside,Big West,23,260,27,84,20,57,7,27,15,25,9,40,49,13,11,4,12,25,76
2865,J.C. Washington,FR,2014-15,F,Houston,AAC,27,457,33,74,31,72,2,2,8,19,36,47,83,11,11,11,19,66,76
2866,Martynas Bareika,SR,2014-15,G,Chattanooga,Southern,21,159,25,69,13,26,12,43,13,19,4,14,18,9,2,0,11,15,75
2867,Marcel Boyd,SO,2014-15,C,Howard,MEAC,31,553,28,65,28,65,0,0,19,36,54,86,140,10,8,32,37,83,75
2868,Emmanuel Chibuogwu,FR,2014-15,G,Seattle,WAC,28,354,26,51,25,43,1,8,22,48,12,27,39,22,7,3,25,35,75
2869,Isaiah Dennis,SO,2014-15,G,Georgia State,Sun Belt,28,255,31,60,31,59,0,1,13,30,14,20,34,22,16,6,10,29,75
2870,Elias Desport,JR,2014-15,F,Saint Peter's,MAAC,34,498,27,71,27,70,0,1,21,31,30,44,74,13,11,19,31,78,75
2871,Frederic Dure,JR,2014-15,G,Arkansas State,Sun Belt,12,222,24,55,9,25,15,30,12,19,2,32,34,13,6,0,21,17,75
2872,Austin Etherington,SR,2014-15,F,Butler,Big East,32,392,26,68,16,30,10,38,13,14,18,49,67,17,9,3,22,67,75
2873,JaMarkus Horace,JR,2014-15,F,Nicholls State,Southland,29,316,33,71,33,71,0,0,9,27,26,31,57,15,6,11,33,59,75
2874,Braxton Huggins,FR,2014-15,G,New Mexico State,WAC,27,216,25,74,13,29,12,45,13,15,8,11,19,11,8,3,14,23,75
2875,Jacob Ivory,FR,2014-15,G,Middle Tennessee,CUSA,22,268,20,54,19,44,1,10,34,44,4,18,22,24,4,0,28,26,75
2876,Brendan Kilpatrick,SO,2014-15,G-F,Vermont,AEC,21,252,24,62,20,47,4,15,23,34,9,24,33,7,6,6,18,31,75
2877,Chuck Ogbodo,SO,2014-15,F,North Carolina-Wilmington,CAA,30,361,31,50,31,50,0,0,13,19,35,61,96,3,11,25,20,55,75
2878,Ron Patterson,SO,2014-15,G,Syracuse,ACC,29,404,31,99,22,47,9,52,4,14,9,17,26,49,20,4,15,32,75
2879,Josh Smith,JR,2014-15,F,Clemson,ACC,31,296,26,50,26,50,0,0,23,37,30,54,84,4,7,6,17,29,75
2880,Quinton Thomas,FR,2014-15,G,Nicholls State,Southland,19,220,20,47,18,29,2,18,33,53,4,26,30,9,11,6,10,27,75
2881,Jordan Watkins,FR,2014-15,G,Davidson,A-10,23,241,23,53,10,24,13,29,16,23,7,21,28,18,8,1,13,19,75
2882,Jabari Alex,JR,2014-15,F,Mississippi Valley State,SWAC,20,364,34,59,34,58,0,1,6,11,24,51,75,9,11,9,23,48,74
2883,Kevin Allen,JR,2014-15,C,Boise State,MWC,21,164,30,47,30,47,0,0,14,23,10,26,36,1,2,1,11,29,74
2884,Kyle Doyle,SO,2014-15,F,Georgia Southern,Sun Belt,29,352,31,74,30,70,1,4,11,29,29,38,67,10,10,13,29,51,74
2885,Chase Flint,SR,2014-15,G,Loyola Marymount,WCC,31,651,26,81,15,43,11,38,11,17,12,49,61,113,40,0,46,55,74
2886,Jake Giesler,JR,2014-15,C,Northern Kentucky,A-Sun,28,366,31,68,31,60,0,8,12,26,26,58,84,13,7,13,17,54,74
2887,Kenneth Hall,SR,2014-15,F,Western Carolina,Southern,32,443,30,62,30,62,0,0,14,22,27,48,75,21,7,23,20,79,74
2888,Michael Hutchins,JR,2014-15,F,Alabama A&amp;M,SWAC,29,436,25,71,16,33,9,38,15,20,20,48,68,18,4,5,16,73,74
2889,Michael Obacha,JR,2014-15,F,Appalachian State,Sun Belt,25,393,24,49,24,49,0,0,26,41,33,55,88,14,6,2,24,50,74
2890,Darryl Smith,SO,2014-15,G,Cornell,Ivy,30,478,25,67,17,36,8,31,16,21,4,49,53,20,13,3,20,39,74
2891,Justus Stanback,SO,2014-15,F,IUPUI,Summit,31,274,37,71,37,69,0,2,0,1,7,29,36,7,9,7,23,37,74
2892,Caleb Crayton,JR,2014-15,G-F,Houston Baptist,Southland,20,222,28,65,26,48,2,17,15,21,17,30,47,12,5,4,19,37,73
2893,Aric Dickerson,JR,2014-15,G,Delaware State,MEAC,31,343,26,92,9,26,17,66,4,6,2,18,20,8,10,1,25,29,73
2894,Landon Goesling,FR,2014-15,G,Appalachian State,Sun Belt,29,300,24,73,18,44,6,29,19,30,12,24,36,18,5,0,24,29,73
2895,Max Hoetzel,FR,2014-15,F,Indiana,Big Ten,31,240,24,56,14,27,10,29,15,21,10,31,41,10,4,3,13,32,73
2896,David Howard,SO,2014-15,F,Evansville,MVC,25,163,25,46,25,46,0,0,23,41,11,17,28,3,3,4,3,33,73
2897,Aaron Jones,JR,2014-15,F,Mississippi,SEC,24,309,27,57,27,56,0,1,19,23,24,36,60,9,14,18,13,41,73
2898,Christopher Morgan,JR,2014-15,F,Holy Cross,Patriot,27,283,31,47,31,47,0,0,11,17,15,27,42,1,2,5,11,43,73
2899,Keith Pinckney,FR,2014-15,G,Tulane,AAC,31,291,31,74,30,63,1,11,10,21,2,15,17,20,12,0,30,18,73
2900,Ryan Smith,SO,2014-15,C,Tulane,AAC,31,320,32,64,32,63,0,1,9,22,24,42,66,2,5,11,22,60,73
2901,Tristan Thomas,SO,2014-15,G,South Carolina Upstate,A-Sun,23,154,24,56,1,3,23,53,2,4,5,6,11,15,8,1,8,18,73
2902,Sidney Umude,FR,2014-15,F,Youngstown State,Horizon,22,227,24,51,24,49,0,2,25,48,18,27,45,10,8,5,20,32,73
2903,Shane Henry,JR,2014-15,F,Virginia Tech,ACC,31,318,31,73,31,73,0,0,10,22,26,58,84,3,8,28,21,53,72
2904,Anthony Lee,SR,2014-15,F,Ohio State,Big Ten,21,230,31,50,31,50,0,0,10,19,16,32,48,3,1,8,13,37,72
2905,Sviatoslav Mykhailiuk,FR,2014-15,G,Kansas,Big 12,26,291,26,85,11,33,15,52,5,6,8,23,31,17,8,1,15,17,72
2906,Richard Peters,SO,2014-15,C,Albany (NY),AEC,31,339,31,52,31,52,0,0,10,21,21,49,70,4,5,7,19,46,72
2907,Zak Showalter,SO,2014-15,G,Wisconsin,Big Ten,35,265,23,53,21,39,2,14,24,27,18,27,45,16,10,4,5,38,72
2908,P.J. Thompson,FR,2014-15,G,Purdue,Big Ten,30,407,24,72,10,23,14,49,10,13,10,18,28,33,21,1,19,39,72
2909,Elijah Watson,FR,2014-15,G,Texas-Pan American,WAC,29,581,24,61,24,52,0,9,24,51,10,37,47,89,19,1,48,66,72
2910,A.J. Avery,JR,2014-15,F,Western Michigan,MAC,28,289,23,60,23,60,0,0,25,41,37,45,82,4,4,16,16,43,71
2911,Sam Cassell,SO,2014-15,G,Connecticut,AAC,18,271,21,76,8,27,13,49,16,20,4,20,24,17,9,0,7,17,71
2912,Caleb Chowbay,SO,2014-15,G,Belmont,OVC,28,236,25,52,17,35,8,17,13,16,2,26,28,23,7,0,24,19,71
2913,Calvin Crawford,SO,2014-15,F,Manhattan,MAAC,30,234,27,75,19,41,8,34,9,16,14,32,46,7,8,4,15,25,71
2914,Travis Hester,SO,2014-15,G,Saint Peter's,MAAC,20,165,21,54,0,3,21,51,8,8,3,13,16,11,1,1,13,9,71
2915,Keon Hill,SO,2014-15,G,Howard,MEAC,32,317,24,69,18,47,6,22,17,23,1,13,14,38,8,0,27,16,71
2916,Corey Hilliard,SR,2014-15,G,San Francisco,WCC,25,300,27,78,18,48,9,30,8,17,5,17,22,20,10,1,13,28,71
2917,Dre'Sean Looney,FR,2014-15,G,Jackson State,SWAC,19,265,24,70,15,37,9,33,14,16,5,15,20,25,8,0,23,34,71
2918,Christian Mackey,FR,2014-15,C,Denver,Summit,25,265,28,43,27,39,1,4,14,18,14,31,45,25,1,8,18,58,71
2919,Michael Ojo,JR,2014-15,C,Florida State,ACC,33,292,27,51,27,51,0,0,17,44,24,54,78,6,5,16,28,44,71
2920,Anthony Perez,JR,2014-15,F,Mississippi,SEC,27,290,21,73,8,29,13,44,16,27,24,29,53,6,8,4,13,25,71
2921,Jordan Session,FR,2014-15,F,Georgia State,Sun Belt,32,208,28,51,27,50,1,1,14,25,12,26,38,7,6,8,12,32,71
2922,Thaddeus Smith,JR,2014-15,C,Missouri-Kansas City,WAC,30,525,29,64,29,64,0,0,13,29,60,72,132,3,19,44,30,78,71
2923,Basil Thompson,FR,2014-15,F,Saint Francis (PA),NEC,23,242,26,66,23,44,3,22,16,23,16,33,49,4,8,7,14,35,71
2924,Brett Bailey,SO,2014-15,F,San Diego,WCC,30,357,28,75,22,56,6,19,8,19,20,59,79,12,6,2,24,35,70
2925,Ivo Basor,JR,2014-15,C,San Jose State,MWC,25,485,27,61,24,51,3,10,13,29,39,56,95,9,6,4,26,62,70
2926,Sheldon Blackwell,SO,2014-15,G,Cal State Fullerton,Big West,31,529,22,67,20,58,2,9,24,40,14,52,66,36,18,0,24,32,70
2927,Ty Egbert,SO,2014-15,F,Idaho,Big Sky,27,289,26,53,26,53,0,0,18,24,18,44,62,5,1,8,12,41,70
2928,Glenn Feidanga,SO,2014-15,F-C,Long Island University,NEC,17,245,22,55,22,54,0,1,26,34,32,30,62,2,3,3,5,44,70
2929,Zach Garber,SO,2014-15,C,Toledo,MAC,33,423,14,45,14,40,0,5,42,58,34,46,80,6,5,8,14,74,70
2930,Prince Ibeh,JR,2014-15,C,Texas,Big 12,34,359,29,49,29,49,0,0,12,32,23,62,85,6,11,47,22,68,70
2931,Shayok M. Shayok,JR,2014-15,F,Missouri-Kansas City,WAC,8,207,28,50,26,48,2,2,12,24,19,37,56,6,7,6,16,19,70
2932,Vlad Shustov,FR,2014-15,F,NJIT,Ind,28,256,31,66,29,59,2,7,6,12,15,29,44,7,3,11,17,41,70
2933,Chris Thompson,JR,2014-15,F,Southern Utah,Big Sky,21,196,28,64,18,39,10,25,4,5,8,39,47,3,3,11,22,17,70
2934,Iakeem Alston,JR,2014-15,G,St. Bonaventure,A-10,29,307,24,67,23,60,1,7,20,39,5,24,29,42,19,0,30,26,69
2935,Robert Cartwright,FR,2014-15,G,Stanford,Pac-12,36,399,23,64,11,28,12,36,11,17,6,28,34,24,9,1,13,38,69
2936,Joe Furstinger,FR,2014-15,F,New Mexico,MWC,29,359,24,67,23,57,1,10,20,35,20,37,57,22,4,15,16,53,69
2937,Devonte Hampton,SO,2014-15,G,Alcorn State,SWAC,20,345,25,79,13,31,12,48,7,11,8,33,41,28,13,3,21,30,69
2938,Yunus Hopkinson,SO,2014-15,G,St. Francis (NY),NEC,27,286,21,85,12,33,9,52,18,21,2,15,17,18,10,0,17,34,69
2939,Asad Lamot,JR,2014-15,G,North Carolina-Greensboro,Southern,30,343,24,56,10,20,14,36,7,12,6,24,30,18,10,2,13,45,69
2940,Chance Murray,SO,2014-15,G,Arizona State,Pac-12,29,249,22,55,19,44,3,11,22,34,3,27,30,31,4,4,20,22,69
2941,Emmanuel Okoroba,SR,2014-15,C,Hampton,MEAC,26,294,19,60,19,60,0,0,31,57,20,41,61,10,4,9,26,62,69
2942,Jalen Rhea,SO,2014-15,G,American,Patriot,26,207,24,46,11,14,13,32,8,10,16,8,24,3,3,0,6,17,69
2943,Aaron Rountree,JR,2014-15,F,Wake Forest,ACC,25,359,26,61,25,58,1,3,16,29,29,33,62,28,13,17,19,39,69
2944,Marko Gujanicic,JR,2014-15,F,George Mason,A-10,25,282,30,63,27,53,3,10,5,12,15,27,42,16,4,3,14,33,68
2945,Theo Pinson,FR,2014-15,F-G,North Carolina,ACC,24,300,25,68,18,42,7,26,11,18,21,51,72,37,14,5,17,22,68
2946,Jalon Plummer,SO,2014-15,G,Youngstown State,Horizon,17,336,23,77,15,38,8,39,14,22,13,28,41,16,9,1,18,33,68
2947,Lance Potier,SO,2014-15,G-F,McNeese State,Southland,27,264,27,68,19,39,8,29,6,11,18,33,51,7,7,10,18,29,68
2948,Jeremy Purvis,GR,2014-15,G,Austin Peay,OVC,22,387,21,66,3,8,18,58,8,11,4,21,25,37,16,0,13,24,68
2949,Colton Ray-St Cyr,SO,2014-15,G,Coastal Carolina,Big South,34,280,26,72,16,30,10,42,6,15,27,46,73,14,19,6,16,32,68
2950,Iziahiah Sweeney,FR,2014-15,G,Portland State,Big Sky,25,302,29,77,25,57,4,20,6,11,7,13,20,18,8,6,9,29,68
2951,Dom Uhl,FR,2014-15,F,Iowa,Big Ten,33,331,26,72,21,45,5,27,11,21,22,39,61,14,8,7,23,25,68
2952,Sam Beeler,JR,2014-15,F,California-Santa Barbara,Big West,33,298,29,59,29,59,0,0,9,15,29,43,72,2,5,20,15,47,67
2953,Kendall Griffin,SR,2014-15,G,Wright State,Horizon,8,170,17,34,7,11,10,23,23,28,4,16,20,12,8,9,15,16,67
2954,Khadeem Lattin,FR,2014-15,F,Oklahoma,Big 12,34,403,28,65,28,64,0,1,11,21,39,70,109,9,12,31,14,68,67
2955,Tavario Miller,SO,2014-15,F,Texas A&amp;M,SEC,25,283,28,44,28,43,0,1,11,27,34,42,76,5,1,9,18,62,67
2956,Adam Weir,FR,2014-15,G,Canisius,MAAC,33,359,22,94,7,32,15,62,8,12,13,27,40,24,10,5,12,47,67
2957,Charles Burley,SR,2014-15,G,Delaware State,MEAC,33,603,16,56,10,36,6,20,28,42,24,53,77,88,21,0,63,60,66
2958,Deng Deng,JR,2014-15,F,Baylor,Big 12,23,203,29,56,29,53,0,3,8,16,14,33,47,5,9,6,21,22,66
2959,Jabril Durham,JR,2014-15,G,Arkansas,SEC,36,359,20,66,5,24,15,42,11,14,8,19,27,52,10,0,27,39,66
2960,Calvin Hermanson,FR,2014-15,F,Saint Mary's (CA),WCC,26,216,21,43,6,9,15,34,9,13,5,18,23,4,7,0,5,35,66
2961,Collin Luther,FR,2014-15,F,Elon,CAA,32,389,20,63,7,18,13,45,13,17,22,40,62,17,9,1,15,40,66
2962,Undra Mitchem,SO,2014-15,G,Jacksonville State,OVC,15,222,25,74,12,27,13,47,3,6,5,15,20,16,12,2,10,28,66
2963,Anthony Morse,JR,2014-15,F,Tennessee Tech,OVC,25,257,26,56,26,56,0,0,14,28,26,30,56,8,7,12,11,31,66
2964,Jaleel Queary,SR,2014-15,G,Jackson State,SWAC,23,452,26,66,25,62,1,4,13,32,15,35,50,36,15,4,36,56,66
2965,Ronnie Stevens,SR,2014-15,F-C,Nevada,MWC,22,305,18,46,18,46,0,0,30,45,29,36,65,1,1,9,23,42,66
2966,Greig Stire,FR,2014-15,F,Albany (NY),AEC,33,349,20,48,20,48,0,0,26,39,24,43,67,8,11,2,17,55,66
2967,Isaiah Tripp,FR,2014-15,G,Abilene Christian,Southland,29,209,23,52,18,42,5,10,15,25,13,20,33,11,6,0,10,33,66
2968,Bobby Wehrli,JR,2014-15,F,Dayton,A-10,29,407,24,46,12,22,12,24,6,11,28,34,62,10,6,9,15,50,66
2969,Jan Grzelinski,FR,2014-15,G,Canisius,MAAC,32,501,25,84,16,47,9,37,6,10,8,11,19,60,11,0,42,32,65
2970,Tyler Hadden,SO,2014-15,C,Belmont,OVC,27,150,22,54,16,37,6,17,15,24,7,23,30,4,0,3,11,24,65
2971,Leyton Hammonds,SO,2014-15,G-F,Oklahoma State,Big 12,28,276,24,69,8,21,16,48,1,3,12,15,27,7,5,2,12,41,65
2972,Matt Husek,SO,2014-15,C,Holy Cross,Patriot,22,196,27,75,24,52,3,23,8,17,10,15,25,2,8,15,5,25,65
2973,TJ Lang,FR,2014-15,G,Auburn,SEC,27,372,20,57,6,15,14,42,11,20,12,23,35,12,5,2,13,47,65
2974,Gino Littles,FR,2014-15,G,Texas-San Antonio,CUSA,27,640,25,67,20,35,5,32,10,17,13,38,51,57,17,0,24,37,65
2975,Cody Martin,FR,2014-15,F,North Carolina State,ACC,19,216,28,59,28,52,0,7,9,17,17,21,38,23,9,6,18,36,65
2976,Blaise Mbargorba,SO,2014-15,C,Boston University,Patriot,28,297,26,55,26,55,0,0,13,19,12,31,43,6,2,4,13,38,65
2977,DJ Mlachnik,JR,2014-15,G,Massachusetts-Lowell,AEC,25,228,23,52,5,12,18,40,1,3,6,18,24,6,7,0,5,18,65
2978,Jorge Perez-Laham,SO,2014-15,G,High Point,Big South,22,312,25,53,15,36,10,17,5,11,4,30,34,44,14,1,22,26,65
2979,Fred Richardson,JR,2014-15,G,Colorado State,MWC,22,256,21,55,12,28,9,27,14,14,11,27,38,7,5,0,12,18,65
2980,Danny Upchurch,FR,2014-15,G,Charleston Southern,Big South,30,342,18,83,7,25,11,58,18,27,4,14,18,37,12,1,26,38,65
2981,Terrell Carter,FR,2014-15,C,Fresno State,MWC,18,196,23,49,23,49,0,0,18,35,18,18,36,0,0,4,12,34,64
2982,Bryce Dulin,FR,2014-15,G,Navy,Patriot,23,244,20,57,7,19,13,38,11,16,10,17,27,9,5,2,13,24,64
2983,Kevin Franceschi,JR,2014-15,G,Missouri-Kansas City,WAC,25,211,20,56,16,41,4,15,20,25,9,7,16,9,3,0,26,21,64
2984,Dale Francis,JR,2014-15,F,Texas A&amp;M-Corpus Christi,Southland,30,362,21,65,2,8,19,57,3,4,11,17,28,3,4,4,5,65,64
2985,Damarion Geter,SO,2014-15,F,Longwood,Big South,34,862,29,50,29,50,0,0,6,19,42,103,145,49,29,32,33,99,64
2986,Baryn Houston,JR,2014-15,G-F,Alabama A&amp;M,SWAC,28,297,22,76,14,38,8,38,12,20,15,33,48,5,4,1,5,31,64
2987,Karl Madison,SR,2014-15,G,Drake,MVC,28,595,18,57,13,43,5,14,23,35,8,35,43,73,15,0,40,43,64
2988,Emmanuel Ndumanya,FR,2014-15,C,Santa Clara,WCC,23,267,27,56,27,56,0,0,10,25,27,52,79,4,9,7,13,53,64
2989,Marko Pirovic,SO,2014-15,F,Maine,AEC,9,196,21,48,12,23,9,25,13,24,12,31,43,9,5,0,18,31,64
2990,David Wacker,FR,2014-15,F,Boise State,MWC,29,259,22,49,22,48,0,1,20,30,15,26,41,5,0,6,13,31,64
2991,Jack Whitman,FR,2014-15,F,William &amp; Mary,CAA,28,322,25,45,25,45,0,0,14,30,33,32,65,13,7,14,24,50,64
2992,Isaiah Wright,FR,2014-15,G,Utah,Pac-12,33,416,17,46,4,13,13,33,17,22,3,23,26,57,3,3,27,39,64
2993,Jerimyjah Batts,SO,2014-15,F,Coppin State,MEAC,31,369,25,67,25,67,0,0,13,25,10,30,40,9,1,11,17,79,63
2994,Brian Bridgewater,SO,2014-15,F,Louisiana State,SEC,29,192,28,52,28,52,0,0,7,11,13,18,31,6,7,3,11,36,63
2995,Connor Brooks,SR,2014-15,G-F,Stephen F. Austin,Southland,28,267,21,48,15,29,6,19,15,23,11,17,28,20,16,2,20,24,63
2996,Chad Calcaterra,SR,2014-15,F,North Dakota,Big Sky,19,212,27,47,27,47,0,0,9,21,11,17,28,2,3,8,12,30,63
2997,Sidy Djitte,SO,2014-15,C,Clemson,ACC,30,331,22,48,22,48,0,0,19,34,48,47,95,4,11,17,14,66,63
2998,Kyler Erickson,JR,2014-15,G,Nebraska-Omaha,Summit,22,309,14,39,7,18,7,21,28,38,3,26,29,14,10,1,10,19,63
2999,Drake Green,FR,2014-15,G,Abilene Christian,Southland,28,243,25,79,21,61,4,18,9,16,4,18,22,13,7,2,13,28,63
3000,Connor McClenaghan,FR,2014-15,F-C,Marist,MAAC,30,321,17,53,12,34,5,19,24,37,16,26,42,13,11,13,33,67,63
3001,Fallou Ndoye,FR,2014-15,F,Mississippi State,SEC,30,372,26,54,26,54,0,0,11,21,22,33,55,5,6,7,27,67,63
3002,Chad Ross,SR,2014-15,F,Utah Valley,WAC,19,234,24,57,17,39,7,18,8,15,9,30,39,10,6,1,20,37,63
3003,Jaron Withers,FR,2014-15,G,Presbyterian,Big South,32,412,22,60,20,49,2,11,17,28,4,25,29,16,15,5,20,40,63
3004,Elisha Boone,FR,2014-15,G,Saint Peter's,MAAC,22,216,27,66,24,59,3,7,5,22,16,21,37,4,5,5,14,14,62
3005,Vitto Brown,SO,2014-15,F,Wisconsin,Big Ten,34,214,26,59,26,59,0,0,10,17,12,31,43,7,8,8,15,38,62
3006,Jordan Dembley,FR,2014-15,G,Liberty,Big South,25,364,19,42,12,24,7,18,17,25,8,21,29,42,6,2,25,22,62
3007,Jerran Foster,JR,2014-15,G,Florida A&amp;M,MEAC,28,438,20,92,12,54,8,38,14,28,4,28,32,29,12,0,43,34,62
3008,Khari Harley,FR,2014-15,G-F,Ohio,MAC,24,400,18,50,10,25,8,25,18,20,10,25,35,21,8,5,18,42,62
3009,Jalen Henry,FR,2014-15,F,Southern Illinois-Edwardsville,OVC,26,162,18,41,18,41,0,0,26,37,13,26,39,1,2,9,8,39,62
3010,Josh James,SO,2014-15,G,Monmouth,MAAC,13,305,22,69,17,54,5,15,13,18,7,25,32,16,5,0,22,20,62
3011,Bobby King,SR,2014-15,F,Stephen F. Austin,Southland,32,238,24,43,24,43,0,0,14,27,29,24,53,10,4,15,25,41,62
3012,Ethan Lee,SO,2014-15,F,Central Arkansas,Southland,26,250,20,41,20,40,0,1,22,30,14,26,40,7,7,5,22,46,62
3013,Emmanuel Matey,FR,2014-15,G,Morgan State,MEAC,29,398,19,49,19,47,0,2,24,46,7,28,35,73,14,0,33,36,62
3014,Luke Moyer,JR,2014-15,G,Campbell,Big South,19,187,20,50,2,6,18,44,4,5,4,7,11,10,3,0,14,16,62
3015,Eddie Odio,SR,2014-15,F,Boston College,ACC,29,435,21,59,13,26,8,33,12,17,24,50,74,27,12,11,27,64,62
3016,Bernard Sullivan,JR,2014-15,F,Charlotte,CUSA,13,175,24,51,23,49,1,2,13,21,13,22,35,2,4,3,11,8,62
3017,John Swinton,SR,2014-15,G,Wofford,Southern,32,358,18,43,14,29,4,14,22,25,5,24,29,36,10,2,12,37,62
3018,Austin White,FR,2014-15,G,High Point,Big South,27,210,19,51,17,37,2,14,22,34,4,16,20,12,3,0,9,15,62
3019,Stephon Whyatt,SR,2014-15,G,Saint Francis (PA),NEC,23,250,22,52,16,31,6,21,12,18,4,19,23,19,11,3,20,26,62
3020,Blake Brumwell,SR,2014-15,C,Montana State,Big Sky,30,464,26,51,26,51,0,0,9,19,37,63,100,7,2,3,24,67,61
3021,Zach Chionuma,JR,2014-15,G,Bryant,NEC,14,126,23,60,16,32,7,28,8,18,4,10,14,0,5,0,4,11,61
3022,Anthony Dallier,SO,2014-15,G,Yale,Ivy,27,292,20,56,14,32,6,24,15,21,16,33,49,26,5,4,15,23,61
3023,Sean Harris,SR,2014-15,F,Utah State,MWC,31,384,27,49,27,49,0,0,7,13,31,43,74,15,8,16,16,41,61
3024,Will Johnston,SR,2014-15,G,Virginia Tech,ACC,25,278,20,55,3,9,17,46,4,5,7,18,25,8,3,1,2,22,61
3025,Ryan King,SR,2014-15,F,Northwestern State,Southland,22,237,24,41,24,41,0,0,13,22,22,22,44,4,2,9,4,28,61
3026,Evan Maxwell,FR,2014-15,C,Liberty,Big South,29,176,23,40,23,40,0,0,15,26,11,20,31,0,1,5,17,29,61
3027,Marquel McKinney,SR,2014-15,G,Sam Houston State,Southland,35,453,21,63,10,22,11,41,8,19,25,54,79,22,6,0,22,56,61
3028,David Onuorah,SO,2014-15,C,Cornell,Ivy,30,569,25,56,25,56,0,0,11,28,51,53,104,10,15,45,36,80,61
3029,Dorian Pickens,FR,2014-15,G-F,Stanford,Pac-12,31,267,17,48,8,23,9,25,18,26,18,13,31,17,6,1,14,20,61
3030,Dalvin Roberts,FR,2014-15,G,Florida A&amp;M,MEAC,19,288,13,51,6,19,7,32,28,45,3,14,17,16,5,3,17,35,61
3031,Julian Royal,JR,2014-15,F,George Mason,A-10,18,223,24,67,23,58,1,9,12,18,15,28,43,4,4,5,17,36,61
3032,Alex Thompson,SO,2014-15,F,Auburn,SEC,23,261,19,67,12,30,7,37,16,26,13,30,43,6,5,7,13,34,61
3033,Spencer Turner,SR,2014-15,G,Belmont,OVC,23,211,21,63,4,6,17,57,2,3,5,15,20,12,2,0,11,14,61
3034,Michael Zeno,FR,2014-15,G-F,New Orleans,Southland,28,297,22,53,21,49,1,4,16,34,18,26,44,6,10,11,34,43,61
3035,Kanu Aja,JR,2014-15,F,East Carolina,AAC,29,239,26,62,26,62,0,0,8,18,26,21,47,4,5,2,18,35,60
3036,D.J. Davis,FR,2014-15,G,South Dakota,Summit,32,299,22,62,18,47,4,15,12,22,25,30,55,14,13,1,15,31,60
3037,Jerome Hunter,SR,2014-15,F-C,Eastern Michigan,MAC,35,397,22,38,22,37,0,1,16,24,27,62,89,4,12,13,18,78,60
3038,Cole Martinez,JR,2014-15,G,Texas A&amp;M-Corpus Christi,Southland,28,177,17,51,4,9,13,42,13,13,4,11,15,1,7,1,12,20,60
3039,Robyn Missa,FR,2014-15,F,Nevada,MWC,24,318,23,54,20,44,3,10,11,19,21,43,64,2,2,4,18,29,60
3040,Kingsley Okorah,FR,2014-15,C,California,Pac-12,30,394,24,52,24,52,0,0,12,23,29,37,66,8,8,28,21,59,60
3041,Aaron Ross,SO,2014-15,F,Texas Tech,Big 12,23,227,16,62,14,43,2,19,26,30,11,31,42,8,1,6,21,29,60
3042,Shawn Smith,SR,2014-15,F,Marshall,CUSA,5,124,21,43,12,19,9,24,9,12,2,5,7,3,3,1,7,10,60
3043,Jake Toolson,FR,2014-15,G,Brigham Young,WCC,26,202,21,50,5,10,16,40,2,2,3,34,37,12,7,0,6,18,60
3044,Luke Worthington,SO,2014-15,F,Brigham Young,WCC,33,407,21,46,21,46,0,0,18,27,23,32,55,6,10,2,14,93,60
3045,Joshua Batson,JR,2014-15,G,Chicago State,WAC,29,320,20,77,14,51,6,26,13,25,11,17,28,26,23,1,28,43,59
3046,Bryce Cashman,FR,2014-15,C,North Dakota,Big Sky,23,313,23,41,23,41,0,0,13,34,24,40,64,6,4,12,22,52,59
3047,Patrick Cole,SO,2014-15,G,Siena,MAAC,7,122,21,50,19,39,2,11,15,19,3,16,19,13,4,0,13,20,59
3048,Nathan Dodge,FR,2014-15,G,Army,Patriot,21,165,20,46,4,4,16,42,3,5,2,15,17,7,10,0,10,12,59
3049,Jabbar Singleton,SO,2014-15,G,Oral Roberts,Summit,33,408,16,51,7,21,9,30,18,29,3,21,24,32,6,1,26,23,59
3050,Demarius Smith,JR,2014-15,G,Austin Peay,OVC,16,322,21,68,20,54,1,14,16,33,7,23,30,41,14,3,51,37,59
3051,Milton Washington,JR,2014-15,G,Army,Patriot,17,199,24,50,22,45,2,5,9,14,8,12,20,22,7,2,17,21,59
3052,Corey Barrett,JR,2014-15,F,Central Connecticut State,NEC,27,282,25,68,25,68,0,0,8,16,26,41,67,3,3,9,12,39,58
3053,Nik Biberaj,JR,2014-15,F,Old Dominion,CUSA,28,237,21,61,14,41,7,20,9,14,20,28,48,11,1,4,6,33,58
3054,Jalen Brown,JR,2014-15,F,Georgia State,Sun Belt,32,250,17,41,3,5,14,36,10,20,7,38,45,5,6,4,14,26,58
3055,Joey Frenchwood,FR,2014-15,G,Montana State,Big Sky,24,284,21,63,8,25,13,38,3,5,1,21,22,21,9,2,30,41,58
3056,K.C. Goodwin,FR,2014-15,G,Southern Illinois,MVC,23,418,16,63,4,26,12,37,14,21,5,33,38,21,14,0,33,46,58
3057,Matt Jackson,FR,2014-15,F,Grand Canyon,WAC,22,284,16,50,10,34,6,16,20,27,7,35,42,12,3,2,12,26,58
3058,Kory Kuenstling,FR,2014-15,F-C,Drake,MVC,30,299,16,37,16,37,0,0,26,32,11,28,39,2,4,6,23,37,58
3059,Fletcher Larson,SR,2014-15,F,Youngstown State,Horizon,26,307,25,59,25,59,0,0,8,9,11,30,41,12,3,6,9,49,58
3060,Chudier Pal,SR,2014-15,C,North Carolina-Asheville,Big South,19,195,24,40,24,40,0,0,10,17,19,33,52,16,4,17,10,32,58
3061,Mike Shaw,JR,2014-15,F,Bradley,MVC,31,449,22,64,20,53,2,11,12,29,38,68,106,20,24,16,35,79,58
3062,Sir Washington,FR,2014-15,G,Eastern Washington,Big Sky,22,218,17,42,13,28,4,14,20,24,3,27,30,9,11,1,9,39,58
3063,Devonte Banner,FR,2014-15,G,Norfolk State,MEAC,24,221,18,50,7,22,11,28,10,18,4,14,18,16,7,2,13,25,57
3064,Mark Cornelius,SR,2014-15,G,Massachusetts-Lowell,AEC,25,313,21,67,15,42,6,25,9,14,11,25,36,21,10,0,21,29,57
3065,Ibby Djimde,JR,2014-15,C,Southern Illinois,MVC,24,287,24,53,24,53,0,0,9,15,17,10,27,7,4,6,17,57,57
3066,DeOndre Haynes,SO,2014-15,G,Tennessee Tech,OVC,27,289,20,63,19,52,1,11,16,25,5,28,33,32,9,1,26,14,57
3067,Kai Healy,FR,2014-15,G,Santa Clara,WCC,22,230,20,38,12,20,8,18,9,11,6,14,20,4,7,1,12,22,57
3068,Carlton Hurst,SO,2014-15,G,Colorado State,MWC,31,283,24,47,23,43,1,4,8,16,14,31,45,7,6,5,9,31,57
3069,Brett Jolly,FR,2014-15,F,Saint Louis,A-10,30,326,13,50,11,31,2,19,29,39,11,15,26,12,6,12,18,57,57
3070,Kregg Jones,SR,2014-15,F,Cal State Bakersfield,WAC,27,221,21,41,21,41,0,0,15,35,9,27,36,0,2,10,11,24,57
3071,Jonathan Joseph,FR,2014-15,F,Stetson,A-Sun,15,218,20,42,16,28,4,14,13,23,12,27,39,5,3,7,21,32,57
3072,Justin Martin,SR,2014-15,F,Southern Methodist,AAC,10,122,20,40,16,27,4,13,13,18,3,19,22,7,4,0,10,9,57
3073,Quadri Moore,FR,2014-15,F,Cincinnati,AAC,26,213,21,56,17,42,4,14,11,15,6,22,28,6,7,4,19,26,57
3074,Charle Wilson-Fisher,FR,2014-15,F,Hampton,MEAC,19,199,25,51,23,41,2,10,5,11,19,35,54,6,7,6,14,32,57
3075,Oliver Black,FR,2014-15,F,Mississippi State,SEC,31,490,22,45,22,45,0,0,12,27,24,51,75,8,12,8,24,59,56
3076,Simi Fajemisin,SR,2014-15,F-C,San Diego,WCC,31,269,24,40,24,40,0,0,8,16,26,33,59,2,3,9,6,54,56
3077,Grant Fiorentinos,JR,2014-15,F-C,Southern Illinois-Edwardsville,OVC,26,248,22,46,21,44,1,2,11,15,19,28,47,7,8,3,13,44,56
3078,Malik Gray,FR,2014-15,G,Norfolk State,MEAC,20,172,18,47,4,12,14,35,6,16,3,20,23,4,5,3,11,32,56
3079,Malek Harris,FR,2014-15,F,Kansas State,Big 12,27,336,21,53,21,50,0,3,14,23,17,33,50,14,2,0,18,38,56
3080,Taylor Johnson,FR,2014-15,G,Dartmouth,Ivy,23,195,15,38,8,17,7,21,19,24,6,13,19,8,5,0,16,22,56
3081,Mario Karailiev,SO,2014-15,C,Florida A&amp;M,MEAC,29,443,26,55,26,55,0,0,4,14,24,39,63,3,3,14,32,50,56
3082,Bakary Konate,FR,2014-15,C,Minnesota,Big Ten,25,222,19,35,19,35,0,0,18,34,18,34,52,6,10,10,16,39,56
3083,John Manning,SR,2014-15,C,Saint Louis,A-10,28,401,21,52,21,51,0,1,14,18,8,45,53,14,5,23,16,49,56
3084,Dalton Nixon,FR,2014-15,F,Brigham Young,WCC,27,262,20,47,17,29,3,18,13,13,12,33,45,21,4,4,12,32,56
3085,Magnus Richards,SO,2014-15,F,Binghamton,AEC,26,258,19,43,19,42,0,1,18,32,18,33,51,5,8,6,25,45,56
3086,Adam Thoseby,JR,2014-15,G,South Dakota,Summit,25,143,19,58,13,32,6,26,12,17,3,18,21,5,2,0,6,14,56
3087,D.J. Bennett,SR,2014-15,F,Oklahoma,Big 12,29,226,21,42,21,42,0,0,13,24,15,35,50,3,4,19,10,44,55
3088,Marcus Burwell,JR,2014-15,F,Sam Houston State,Southland,28,283,20,54,14,34,6,20,9,18,18,32,50,12,2,12,12,25,55
3089,D'Marnier Cunningham,JR,2014-15,G,Memphis,AAC,20,217,22,59,19,49,3,10,8,11,3,12,15,33,15,4,22,22,55
3090,Tarekeyi Edogi,SO,2014-15,F,Tulsa,AAC,32,238,21,37,21,37,0,0,13,36,22,30,52,0,2,7,11,29,55
3091,Alvin Ellis,FR,2014-15,F,Michigan State,Big Ten,32,274,17,53,11,28,6,25,15,33,4,18,22,18,12,5,18,32,55
3092,Brandon Ford,JR,2014-15,G,Howard,MEAC,18,195,21,44,17,29,4,15,9,11,2,7,9,6,9,0,11,10,55
3093,Kendall Jackson,SO,2014-15,G,Columbia,Ivy,22,203,17,35,7,10,10,25,11,13,2,12,14,10,8,0,11,22,55
3094,Jalen James,SO,2014-15,G,San Jose State,MWC,8,201,20,47,15,29,5,18,10,14,5,26,31,17,4,1,20,11,55
3095,Janeil Jenkins,JR,2014-15,G,Presbyterian,Big South,27,297,19,35,14,23,5,12,12,22,0,19,19,30,10,0,26,24,55
3096,Jermaine Morgan,JR,2014-15,F,Bradley,MVC,22,267,21,62,21,61,0,1,13,28,24,35,59,4,9,4,20,54,55
3097,Rauno Nurger,FR,2014-15,C,Wichita State,MVC,24,212,18,38,13,20,5,18,14,20,8,20,28,4,3,9,8,29,55
3098,Jalyn Pennie,FR,2014-15,G,New Mexico State,WAC,25,227,25,50,25,47,0,3,5,19,27,41,68,3,2,13,19,25,55
3099,Tyler Stone,SO,2014-15,F,Howard,MEAC,32,243,18,38,16,36,2,2,17,25,12,32,44,4,14,9,12,35,55
3100,Austin Torres,SO,2014-15,F,Notre Dame,ACC,27,192,24,35,24,35,0,0,7,10,17,27,44,4,3,1,6,21,55
3101,Craig Brown,SR,2014-15,G-F,Kent State,MAC,33,361,17,75,12,50,5,25,15,23,28,31,59,8,4,2,19,50,54
3102,Joel Fiegler,JR,2014-15,F,Central Arkansas,Southland,28,304,22,50,22,47,0,3,10,13,11,50,61,13,8,27,35,57,54
3103,Demonte Flannigan,SO,2014-15,F,Cleveland State,Horizon,29,208,24,40,24,39,0,1,6,19,16,19,35,3,3,6,11,29,54
3104,Dimitri Floras,FR,2014-15,G,Quinnipiac,MAAC,26,297,17,72,7,31,10,41,10,15,17,26,43,28,8,0,15,33,54
3105,Michael Grant,SO,2014-15,G,Abilene Christian,Southland,25,216,15,44,15,43,0,1,24,37,13,21,34,4,17,1,15,34,54
3106,Javis Howard,FR,2014-15,F,Charleston Southern,Big South,25,173,25,41,24,37,1,4,3,4,11,15,26,5,4,1,10,23,54
3107,Travon Landry,SO,2014-15,G,New Mexico State,WAC,27,322,16,46,15,40,1,6,21,29,1,34,35,25,7,1,17,25,54
3108,Stephane Manga,SR,2014-15,G-F,Seton Hall,Big East,21,258,22,57,20,47,2,10,8,16,7,25,32,6,8,6,24,30,54
3109,Keenan Simmons,FR,2014-15,F,Southern Illinois-Edwardsville,OVC,16,134,22,40,14,22,8,18,2,4,4,23,27,1,0,13,3,14,54
3110,Tyvoris Soloman,FR,2014-15,G,South Carolina State,MEAC,29,538,16,52,10,34,6,18,16,27,18,47,65,80,25,1,37,52,54
3111,Jack Anton,FR,2014-15,F,Elon,CAA,31,351,19,46,17,39,2,7,13,20,10,36,46,5,2,1,5,45,53
3112,Wil Bathurst,FR,2014-15,G-F,Cornell,Ivy,22,156,18,46,13,32,5,14,12,27,7,26,33,4,7,2,8,17,53
3113,Brandon Chauca,FR,2014-15,G,California,Pac-12,22,210,19,47,7,16,12,31,3,6,0,14,14,15,2,0,19,21,53
3114,R.J. Curington,SO,2014-15,G,DePaul,Big East,21,123,18,38,11,23,7,15,10,13,4,10,14,5,4,2,9,20,53
3115,Kevin Degnan,FR,2014-15,F-C,Fairfield,MAAC,21,226,20,57,15,32,5,25,8,14,6,37,43,5,4,4,11,27,53
3116,Charleston Dobbs,JR,2014-15,F,Prairie View,SWAC,31,331,24,59,24,58,0,1,5,12,20,42,62,2,5,9,11,62,53
3117,Todd Eaglin,JR,2014-15,G,North Texas,CUSA,28,383,18,44,9,18,9,26,8,12,4,30,34,32,15,3,32,41,53
3118,Jeremiah Eason,SR,2014-15,F,Southern Mississippi,CUSA,18,446,20,68,20,65,0,3,13,37,22,42,64,14,5,3,18,32,53
3119,Zach Elcano,JR,2014-15,C,American,Patriot,22,331,21,47,21,47,0,0,11,22,9,31,40,21,5,11,32,36,53
3120,Charles Glover,FR,2014-15,G,Mount St. Mary's,NEC,27,397,14,55,7,23,7,32,18,22,3,23,26,27,14,2,24,53,53
3121,Jeremy Jones,FR,2014-15,F,Rice,CUSA,24,346,19,38,18,35,1,3,14,33,15,52,67,7,21,10,16,54,53
3122,Junior Lomomba,SO,2014-15,G,Providence,Big East,31,344,15,46,13,35,2,11,21,32,11,26,37,13,8,1,13,27,53
3123,Jason Massey,FR,2014-15,G,Brown,Ivy,30,292,22,47,21,45,1,2,8,20,16,17,33,16,5,2,11,31,53
3124,Chandler Rowe,FR,2014-15,F,Tennessee-Martin,OVC,34,357,17,43,16,42,1,1,18,27,29,41,70,13,10,6,18,69,53
3125,Leslee Smith,SR,2014-15,F,Nebraska,Big Ten,17,214,23,50,23,50,0,0,7,16,18,35,53,9,10,9,15,28,53
3126,Trinson White,JR,2014-15,G-F,Milwaukee,Horizon,19,254,13,43,11,38,2,5,25,36,16,20,36,13,5,3,16,16,53
3127,Keenen Anderson,SR,2014-15,F,Eastern Illinois,OVC,26,260,20,46,20,46,0,0,12,27,22,19,41,3,6,6,5,32,52
3128,Brett Bisping,JR,2014-15,F,Siena,MAAC,6,141,18,38,16,29,2,9,14,19,13,15,28,7,4,4,9,25,52
3129,Connor Devine,SO,2014-15,F,South Dakota State,Summit,25,246,18,30,18,30,0,0,16,38,27,27,54,3,4,28,13,45,52
3130,Devin Foster,JR,2014-15,G,Penn State,Big Ten,19,243,19,33,17,28,2,5,12,19,14,24,38,11,6,1,15,21,52
3131,Mrdjan Gasevic,SO,2014-15,F-C,Delaware State,MEAC,26,222,22,46,22,46,0,0,8,21,25,40,65,4,5,4,15,33,52
3132,Terry Harris,FR,2014-15,G-F,Houston Baptist,Southland,20,163,17,53,11,30,6,23,12,17,10,18,28,6,5,2,9,18,52
3133,Brandon Hayman,SR,2014-15,G,Samford,Southern,29,192,26,50,26,50,0,0,0,6,17,28,45,9,10,3,14,31,52
3134,Corey Henderson,FR,2014-15,G,Wichita State,MVC,28,191,18,62,6,24,12,38,4,8,3,8,11,6,5,1,7,17,52
3135,Josh Henderson,SR,2014-15,C,Vanderbilt,SEC,24,175,22,44,22,42,0,2,8,13,13,16,29,3,2,2,8,24,52
3136,Enoch Hood,JR,2014-15,F,North Carolina Central,MEAC,28,226,21,43,21,43,0,0,10,22,18,32,50,1,7,7,12,34,52
3137,Dylon Maggio,FR,2014-15,G,Southeastern Louisiana,Southland,26,249,19,45,7,22,12,23,2,5,4,19,23,7,8,4,24,31,52
3138,Andrew Scocca,SO,2014-15,F,Bryant,NEC,30,360,17,40,17,39,0,1,18,25,20,51,71,16,2,9,21,45,52
3139,Johnnie Shuler,FR,2014-15,G,La Salle,A-10,23,142,15,41,3,8,12,33,10,17,6,10,16,6,2,0,12,13,52
3140,Lance Stokes,JR,2014-15,F,Chattanooga,Southern,30,350,18,41,18,41,0,0,16,24,15,36,51,7,13,6,15,39,52
3141,T.J. Taylor,JR,2014-15,G,California-Santa Barbara,Big West,32,293,16,45,3,10,13,35,7,8,3,12,15,40,7,0,13,21,52
3142,Deonte Burton,SO,2014-15,G-F,Marquette,Big East,8,129,17,36,13,26,4,10,13,17,5,6,11,2,10,3,11,16,51
3143,Daniel Edozie,SR,2014-15,F,Iowa State,Big 12,16,148,16,28,16,28,0,0,19,27,23,17,40,6,3,1,7,18,51
3144,C.J. Foster,SO,2014-15,G,Arkansas State,Sun Belt,22,312,15,51,12,35,3,16,18,28,13,10,23,14,3,1,18,30,51
3145,Michael Gilmore,FR,2014-15,F,Virginia Commonwealth,A-10,26,157,21,43,16,26,5,17,4,16,11,28,39,4,5,6,4,31,51
3146,Michael Hoffman,SO,2014-15,F,Lafayette,Patriot,32,278,20,47,14,28,6,19,5,8,10,36,46,10,3,7,8,27,51
3147,Max Joseph,FR,2014-15,G,Valparaiso,Horizon,28,306,16,37,12,25,4,12,15,28,9,19,28,31,8,3,27,31,51
3148,Viktor Juricek,JR,2014-15,F,Texas A&amp;M-Corpus Christi,Southland,29,198,14,47,9,26,5,21,18,24,14,10,24,5,3,2,23,41,51
3149,Cullen Neal,SO,2014-15,G,New Mexico,MWC,3,89,13,35,5,19,8,16,17,20,0,4,4,11,2,0,7,7,51
3150,Taj Owens,JR,2014-15,G,Radford,Big South,27,220,17,40,15,34,2,6,15,18,5,14,19,28,8,0,13,22,51
3151,Matt Sellers,SR,2014-15,F,Wyoming,MWC,15,141,21,31,21,31,0,0,9,15,8,17,25,7,1,6,13,17,51
3152,Deshaun Sunderhaus,JR,2014-15,F,Seattle,WAC,8,125,21,31,21,31,0,0,9,13,16,11,27,6,1,3,5,14,51
3153,Kyle Toth,JR,2014-15,G,Cal Poly,Big West,11,207,18,42,3,6,15,36,0,3,2,21,23,7,2,1,1,10,51
3154,Emmanuel Tselentakis,JR,2014-15,G,NJIT,Ind,33,409,21,61,17,34,4,27,5,8,22,47,69,26,22,8,17,29,51
3155,Devin Wilson,SR,2014-15,G,North Florida,A-Sun,32,256,13,28,5,14,8,14,17,24,3,18,21,35,12,0,23,19,51
3156,George Brammeier,FR,2014-15,C,Lipscomb,A-Sun,30,231,23,45,23,45,0,0,4,11,15,31,46,1,3,9,13,59,50
3157,Manroop Clair,SO,2014-15,G,Seattle,WAC,16,143,14,53,2,10,12,43,10,13,4,7,11,5,4,0,9,14,50
3158,Evan Cummins,JR,2014-15,F,Harvard,Ivy,21,238,18,32,18,32,0,0,14,24,18,29,47,9,11,6,12,25,50
3159,Quron Davis,C,2014-15,C,Chicago State,WAC,19,223,22,47,22,47,0,0,6,14,25,25,50,4,5,7,17,27,50
3160,Josh Gomez,JR,2014-15,C,Bowling Green State,MAC,25,173,21,38,20,37,1,1,7,12,14,27,41,3,5,9,10,31,50
3161,Chris Hawkins,JR,2014-15,F,Memphis,AAC,18,205,20,41,18,37,2,4,8,14,21,27,48,10,7,2,10,21,50
3162,Ria'n Holland,FR,2014-15,G,Wichita State,MVC,27,229,17,53,5,18,12,35,4,4,8,12,20,10,6,1,7,27,50
3163,Youssoupha Kane,JR,2014-15,F,Detroit Mercy,Horizon,24,311,21,51,21,51,0,0,8,19,25,35,60,7,9,11,19,53,50
3164,Jack Lopez,SO,2014-15,G,Montana,Big Sky,31,322,18,45,9,19,9,26,5,12,10,41,51,11,12,8,9,38,50
3165,Julian Moore,FR,2014-15,F,Penn State,Big Ten,33,250,21,40,20,39,1,1,7,18,18,36,54,1,3,12,17,34,50
3166,Aaron Morgan,JR,2014-15,G,Maryland-Baltimore County,AEC,10,219,13,46,2,12,11,34,13,21,5,3,8,13,6,0,21,29,50
3167,Phillip Nolan,JR,2014-15,F,Connecticut,AAC,34,516,23,49,23,49,0,0,4,14,29,34,63,4,7,14,21,90,50
3168,Trent Perry,FR,2014-15,G,Eastern Michigan,MAC,21,160,18,46,5,11,13,35,1,3,2,7,9,6,3,0,3,6,50
3169,Brett Prahl,FR,2014-15,F,Milwaukee,Horizon,24,189,16,31,16,29,0,2,18,28,11,19,30,4,5,8,15,27,50
3170,Maurice White,SO,2014-15,G,Siena,MAAC,23,225,14,75,14,72,0,3,22,34,15,23,38,5,9,3,19,25,50
3171,Trevon Woods,FR,2014-15,G-F,Long Island University,NEC,22,158,18,58,10,28,8,30,6,7,11,21,32,4,1,3,13,16,50
3172,Patrick Ackerman,JR,2014-15,C,Detroit Mercy,Horizon,31,322,22,45,22,45,0,0,5,8,6,33,39,1,6,18,9,47,49
3173,Payton Banks,FR,2014-15,F,Penn State,Big Ten,29,252,15,53,4,14,11,39,8,16,6,32,38,2,7,2,12,24,49
3174,Vangelis Bebis,FR,2014-15,G,Iona,MAAC,27,233,17,52,4,8,13,44,2,2,2,18,20,8,8,3,7,24,49
3175,Chase Connor,SO,2014-15,G,West Virginia,Big 12,23,122,17,45,2,2,15,43,0,0,1,3,4,2,11,0,3,14,49
3176,Sam Daly,SO,2014-15,G,Grand Canyon,WAC,21,292,18,38,15,28,3,10,10,18,8,19,27,37,11,2,33,29,49
3177,Duke Douglas,FR,2014-15,G,Denver,Summit,23,240,21,47,21,39,0,8,7,18,7,15,22,8,4,8,17,32,49
3178,Asa Duvall,FR,2014-15,G,Lipscomb,A-Sun,28,214,15,47,7,14,8,33,11,18,2,11,13,10,2,0,8,11,49
3179,Nick Gorski,SO,2014-15,F,Loyola (MD),Patriot,30,310,19,51,18,48,1,3,10,16,20,35,55,9,4,6,20,35,49
3180,Jarred Guest,SR,2014-15,F,Virginia Commonwealth,A-10,34,240,22,47,22,47,0,0,5,11,26,26,52,3,15,3,12,40,49
3181,Jurmelle Hall,JR,2014-15,G,Mississippi Valley State,SWAC,18,173,17,56,6,16,11,40,4,6,9,19,28,7,7,2,10,23,49
3182,Quinton Ray,SO,2014-15,G,Campbell,Big South,32,530,19,57,16,37,3,20,8,12,14,46,60,55,18,0,24,29,49
3183,Taylor Stafford,JR,2014-15,G,Evansville,MVC,29,192,16,43,6,13,10,30,7,10,4,14,18,13,4,0,3,12,49
3184,Lewis Sullivan,FR,2014-15,F,Alabama-Birmingham,CUSA,26,211,19,50,14,31,5,19,6,8,13,35,48,14,6,4,10,24,49
3185,Will Weeks,SO,2014-15,F,North Carolina-Asheville,Big South,11,167,18,36,18,36,0,0,13,21,20,29,49,14,7,0,12,13,49
3186,Noah Allen,SO,2014-15,G-F,UCLA,Pac-12,36,412,15,54,11,29,4,25,14,27,19,45,64,33,6,2,20,37,48
3187,Cameron Blakely,SO,2014-15,F,Charlotte,CUSA,21,149,16,37,5,8,11,29,5,7,3,19,22,4,3,5,9,21,48
3188,Aaron Bodager,SO,2014-15,G,North Florida,A-Sun,21,181,16,48,3,4,13,44,3,4,2,15,17,10,5,0,8,10,48
3189,Phillip Jones,SO,2014-15,F,Texas-San Antonio,CUSA,15,135,17,40,16,34,1,6,13,25,25,18,43,1,6,8,17,26,48
3190,Joe Kilgore,FR,2014-15,G,Texas A&amp;M-Corpus Christi,Southland,24,193,19,49,16,33,3,16,7,12,6,15,21,4,6,3,9,21,48
3191,Tommy McDonnell,SR,2014-15,G,New Hampshire,AEC,32,329,21,38,20,36,1,2,5,14,22,57,79,20,15,2,15,39,48
3192,Eric Moeller,SO,2014-15,F,Florida Gulf Coast,A-Sun,27,253,17,41,16,37,1,4,13,27,13,25,38,6,4,9,25,43,48
3193,Brandon Randolph,SO,2014-15,G,Xavier,Big East,23,224,20,44,14,33,6,11,2,6,4,19,23,25,7,1,12,13,48
3194,Steve Smith,SO,2014-15,F,Fairfield,MAAC,19,171,17,49,3,6,14,43,0,1,2,22,24,7,1,0,4,24,48
3195,Travis Trim,JR,2014-15,G,Maryland-Eastern Shore,MEAC,29,351,21,53,18,45,3,8,3,11,10,29,39,39,21,1,31,59,48
3196,Roderick Davis,FR,2014-15,F,Wright State,Horizon,28,287,21,37,21,37,0,0,5,14,10,28,38,4,2,11,18,50,47
3197,Junior Longrus,JR,2014-15,F,Washington State,Pac-12,31,364,19,38,19,38,0,0,9,28,45,45,90,15,10,12,13,53,47
3198,Daijon Macklien,SO,2014-15,G,Arkansas State,Sun Belt,23,281,18,41,13,28,5,13,6,9,3,18,21,18,6,0,24,21,47
3199,Mario Matasovic,SO,2014-15,F,Western Michigan,MAC,27,236,21,44,21,43,0,1,5,11,20,22,42,5,8,6,15,42,47
3200,Preston Mattingly,SO,2014-15,G,Lamar,Southland,23,287,16,43,16,39,0,4,15,33,12,23,35,18,8,1,13,26,47
3201,Petey McClain,JR,2014-15,G,East Tennessee State,Southern,30,629,16,42,13,28,3,14,12,22,9,54,63,127,30,0,41,53,47
3202,Kendell Ramlal,SO,2014-15,F,Texas State,Sun Belt,31,289,20,41,20,41,0,0,7,18,20,30,50,9,4,20,14,30,47
3203,Cameron Reynolds,SO,2014-15,G,Tulane,AAC,9,119,21,47,16,30,5,17,0,4,8,18,26,11,4,0,6,16,47
3204,Jordan Scott,FR,2014-15,F,Idaho,Big Sky,21,203,18,30,18,30,0,0,11,17,13,19,32,5,3,2,10,25,47
3205,DeVonte Smith,SR,2014-15,G,Arkansas-Little Rock,Sun Belt,21,458,17,38,14,28,3,10,10,26,15,39,54,38,17,1,16,35,47
3206,James Suber,FR,2014-15,F,Niagara,MAAC,21,207,18,32,18,32,0,0,11,18,23,29,52,2,3,4,10,21,47
3207,Wes VanBeck,FR,2014-15,G,Houston,AAC,17,142,15,36,3,11,12,25,5,6,6,15,21,8,0,0,15,16,47
3208,Hikeem Champaigne,SR,2014-15,F-C,Savannah State,MEAC,8,119,20,38,20,38,0,0,6,14,15,15,30,2,3,7,11,17,46
3209,Lucas Dyer,SO,2014-15,F,Radford,Big South,26,203,15,33,15,33,0,0,16,20,13,39,52,4,6,15,8,30,46
3210,Christian Ejiga,SO,2014-15,F,Maine,AEC,23,217,17,41,17,40,0,1,12,17,14,26,40,5,8,9,12,43,46
3211,Gyorgy Goloman,FR,2014-15,F,UCLA,Pac-12,35,377,19,42,13,30,6,12,2,9,8,45,53,20,15,10,18,63,46
3212,Merrill Holden,SO,2014-15,F,Louisiana Tech,CUSA,27,178,17,28,17,27,0,1,12,26,18,17,35,2,4,11,6,25,46
3213,Mustafa Jones,FR,2014-15,F,Central Connecticut State,NEC,29,240,18,52,18,52,0,0,10,17,18,22,40,4,2,12,12,16,46
3214,Simon Krajcovic,FR,2014-15,G,Loyola Marymount,WCC,17,256,18,41,14,29,4,12,6,12,8,20,28,36,13,0,30,27,46
3215,Danny Mahoney,FR,2014-15,G,San Jose State,MWC,25,328,17,71,11,27,6,44,6,6,5,19,24,28,6,0,29,21,46
3216,Moe McDonald,FR,2014-15,G,Texas-Pan American,WAC,26,325,13,46,7,17,6,29,14,23,1,24,25,24,6,1,16,21,46
3217,Roger Moute a Bidias,SO,2014-15,F,California,Pac-12,29,280,16,45,13,31,3,14,11,24,14,26,40,10,3,8,13,24,46
3218,Maurice Rivers,FR,2014-15,F,Rice,CUSA,12,215,17,45,15,37,2,8,10,17,17,26,43,7,2,7,20,28,46
3219,Rodney Simeon,FR,2014-15,G,Tennessee State,OVC,21,232,14,65,1,13,13,52,5,6,5,21,26,4,2,1,15,22,46
3220,Temjae Singleton,JR,2014-15,F,Cal State Fullerton,Big West,21,174,14,46,6,14,8,32,10,19,12,20,32,5,0,0,10,24,46
3221,Dominique Street,FR,2014-15,G,Jackson State,SWAC,10,152,14,63,2,13,12,50,6,7,5,13,18,4,3,1,5,11,46
3222,Isaiah Wilkins,FR,2014-15,F,Virginia,ACC,28,264,19,48,17,45,2,3,6,11,19,50,69,11,5,18,15,26,46
3223,Sherron Wilson,FR,2014-15,F,Southern Utah,Big Sky,26,224,14,53,9,34,5,19,13,21,9,13,22,14,9,1,17,30,46
3224,Valerio Altheimer,JR,2014-15,G,Grambling,SWAC,26,230,17,48,15,35,2,13,9,19,13,21,34,4,5,2,16,28,45
3225,Jake Belford,JR,2014-15,F,Davidson,A-10,6,122,17,33,14,23,3,10,8,11,3,21,24,13,1,3,9,16,45
3226,Keljin Blevins,FR,2014-15,G,Southern Mississippi,CUSA,25,397,15,56,11,25,4,31,11,21,8,36,44,21,8,3,28,32,45
3227,Derrick Brooks,FR,2014-15,G,Wofford,Southern,32,304,18,50,16,39,2,11,7,18,1,30,31,23,8,3,28,25,45
3228,Shaquille Doorson,FR,2014-15,C,Rutgers,Big Ten,29,298,21,44,21,44,0,0,3,13,31,33,64,4,1,13,12,41,45
3229,Jaylon Floyd,SR,2014-15,F,Arkansas-Pine Bluff,SWAC,32,317,17,40,17,38,0,2,11,17,12,40,52,6,4,8,19,46,45
3230,Khaliq Ghani,JR,2014-15,,Yale,Ivy,21,146,13,23,5,8,8,15,11,14,5,12,17,8,3,3,9,15,45
3231,Tyree Griffin,FR,2014-15,G,Oklahoma State,Big 12,32,330,12,40,8,24,4,16,17,23,9,37,46,34,11,1,22,31,45
3232,Devin Joint,SR,2014-15,G-F,South Carolina State,MEAC,28,366,20,48,20,47,0,1,5,15,31,49,80,15,11,5,20,52,45
3233,Dylan Jones,SO,2014-15,F,Pennsylvania,Ivy,22,154,15,32,15,32,0,0,15,26,14,15,29,2,6,4,15,39,45
3234,Isaac Kreuer,SO,2014-15,F-C,Missouri-Kansas City,WAC,29,308,14,38,14,37,0,1,17,21,14,24,38,2,6,9,15,44,45
3235,Jock Landale,FR,2014-15,C,Saint Mary's (CA),WCC,21,105,19,31,19,31,0,0,7,13,3,16,19,2,0,5,13,16,45
3236,Hunter Mickelson,JR,2014-15,F,Kansas,Big 12,19,133,16,32,16,32,0,0,13,15,15,19,34,1,7,19,9,25,45
3237,Michael O'Donnell,JR,2014-15,F,Southern Mississippi,CUSA,25,229,17,43,8,19,9,24,2,5,8,15,23,4,4,3,16,45,45
3238,Gunnar Olafsson,FR,2014-15,G-F,St. Francis (NY),NEC,28,311,15,48,4,6,11,42,4,6,10,23,33,4,6,3,17,27,45
3239,Nigel Snipes,JR,2014-15,F,Western Kentucky,CUSA,24,207,16,57,8,24,8,33,5,6,12,42,54,7,7,2,11,20,45
3240,Noah Springwater,SR,2014-15,G,Columbia,Ivy,23,176,11,29,0,0,11,29,12,14,0,12,12,4,10,4,4,25,45
3241,Victor Bermudez,SR,2014-15,G,Texas State,Sun Belt,22,151,16,49,5,17,11,32,1,5,3,6,9,11,3,0,8,16,44
3242,Anders Broman,SO,2014-15,G,South Dakota State,Summit,19,114,9,23,5,14,4,9,22,33,1,13,14,7,4,0,5,8,44
3243,Nick Colletta,FR,2014-15,G,Marist,MAAC,18,185,16,53,5,10,11,43,1,1,1,12,13,3,4,2,5,7,44
3244,Lawrence Cooks,SO,2014-15,G,Hampton,MEAC,20,169,17,52,13,30,4,22,6,10,6,20,26,5,8,0,12,15,44
3245,Isaiah Cotton,JR,2014-15,C,Alabama A&amp;M,SWAC,24,213,16,35,16,35,0,0,12,34,19,29,48,5,5,12,20,53,44
3246,Stefan Cvrkalj,SR,2014-15,G,Lehigh,Patriot,25,216,16,61,5,13,11,48,1,3,9,24,33,11,5,1,4,23,44
3247,Cam Delaney,FR,2014-15,G,Denver,Summit,18,244,15,46,10,23,5,23,9,14,6,24,30,14,12,1,4,31,44
3248,Ben Dickinson,JR,2014-15,F,North Carolina-Greensboro,Southern,19,200,17,46,17,42,0,4,10,16,19,25,44,5,3,0,15,38,44
3249,K.J. James,FR,2014-15,F,High Point,Big South,24,202,17,33,17,33,0,0,10,25,14,30,44,11,8,5,13,18,44
3250,Jordan Jones,FR,2014-15,F,Kennesaw State,A-Sun,26,248,18,47,18,46,0,1,8,16,13,39,52,4,4,12,3,50,44
3251,Reuben King,JR,2014-15,F,Charleston Southern,Big South,25,232,18,45,13,25,5,20,3,8,16,34,50,4,10,4,23,28,44
3252,Richard Lee,FR,2014-15,G,Tennessee-Martin,OVC,25,184,16,34,6,13,10,21,2,3,4,8,12,2,2,0,4,15,44
3253,RYan Luther,FR,2014-15,F,Pittsburgh,ACC,23,185,18,35,13,24,5,11,3,7,13,11,24,7,1,4,5,22,44
3254,Alex Poythress,JR,2014-15,F,Kentucky,SEC,8,162,16,42,16,35,0,7,12,14,12,18,30,2,4,12,8,17,44
3255,Jalen Richard,SO,2014-15,G,Santa Clara,WCC,29,286,15,44,11,25,4,19,10,18,12,31,43,21,7,1,19,24,44
3256,Keierre Richards,JR,2014-15,G,Savannah State,MEAC,17,343,15,55,14,42,1,13,13,18,5,20,25,14,9,1,23,34,44
3257,Charles Taylor,SO,2014-15,G,Maryland-Baltimore County,AEC,10,154,18,47,18,46,0,1,8,13,13,20,33,7,5,2,17,19,44
3258,Brandon Watkins,SO,2014-15,F,West Virginia,Big 12,23,154,19,41,19,41,0,0,6,14,21,12,33,4,5,14,15,27,44
3259,Olalekan Ajayi,JR,2014-15,F-C,Eastern Michigan,MAC,29,397,14,24,14,24,0,0,15,25,35,72,107,4,13,13,10,65,43
3260,Tyler Bergantino,JR,2014-15,C,Massachusetts,A-10,32,291,20,27,20,27,0,0,3,13,17,25,42,2,3,5,5,44,43
3261,Connor Burchfield,FR,2014-15,G,William &amp; Mary,CAA,18,156,15,36,5,9,10,27,3,3,1,24,25,2,3,0,7,11,43
3262,Austin Colbert,SO,2014-15,F,Illinois,Big Ten,25,190,16,33,13,29,3,4,8,13,24,31,55,2,4,2,7,29,43
3263,Camryn Crocker,SR,2014-15,G,Pennsylvania,Ivy,26,281,14,39,7,20,7,19,8,14,6,26,32,23,8,3,18,27,43
3264,Gabe DeVoe,FR,2014-15,G,Clemson,ACC,19,162,15,56,6,20,9,36,4,7,2,15,17,10,7,0,3,16,43
3265,Will Goff,FR,2014-15,G,Boston University,Patriot,28,238,11,27,3,8,8,19,13,14,4,12,16,9,5,0,7,20,43
3266,Joe Hanstad,SR,2014-15,G,Boise State,MWC,20,207,15,42,6,13,9,29,4,7,2,16,18,15,4,1,6,11,43
3267,David Jesperson,SO,2014-15,F,Pepperdine,WCC,24,267,18,34,15,26,3,8,4,6,12,29,41,7,0,5,10,32,43
3268,Malick Kone,SR,2014-15,G-F,Rutgers,Big Ten,24,278,16,52,12,38,4,14,7,16,15,23,38,15,9,3,16,25,43
3269,Tanner Lancona,SO,2014-15,F,Saint Louis,A-10,22,215,17,52,14,26,3,26,6,18,5,18,23,13,8,1,11,15,43
3270,Cheikh N'diaye,SO,2014-15,C,Oregon State,Pac-12,29,222,20,32,20,32,0,0,3,8,14,25,39,1,2,15,15,43,43
3271,Marcus Neely,SO,2014-15,G,North Carolina-Asheville,Big South,22,214,15,39,15,37,0,2,13,20,18,26,44,9,5,9,8,26,43
3272,Ben Oberfeld,SO,2014-15,C,Bucknell,Patriot,24,185,16,33,16,33,0,0,11,16,15,25,40,1,1,3,5,26,43
3273,Femi Olujobi,FR,2014-15,F,Oakland,Horizon,26,238,15,40,15,31,0,9,13,27,18,24,42,10,2,3,23,30,43
3274,Derrick Randall,SR,2014-15,F,Pittsburgh,ACC,27,211,16,33,16,33,0,0,11,27,31,32,63,0,1,1,12,36,43
3275,Zachary Reynolds,JR,2014-15,F,Northern Arizona,Big Sky,26,234,17,28,17,28,0,0,9,14,33,45,78,2,3,9,9,25,43
3276,Chris Robinson,FR,2014-15,G,Sacred Heart,NEC,21,143,16,50,14,36,2,14,9,22,13,13,26,2,4,0,4,24,43
3277,Khalil Small,FR,2014-15,G,Green Bay,Horizon,20,134,12,36,9,29,3,7,16,25,10,16,26,6,8,0,9,14,43
3278,Austin Sparks,FR,2014-15,F,South Dakota,Summit,19,188,17,23,17,23,0,0,9,13,13,11,24,7,1,6,15,24,43
3279,Tonny Trocha-Morelos,FR,2014-15,C,Texas A&amp;M,SEC,29,297,18,64,18,59,0,5,7,19,23,34,57,5,6,12,11,33,43
3280,Aaron Williams,GR,2014-15,F,Chicago State,WAC,24,250,16,55,15,34,1,21,10,11,12,32,44,3,11,5,16,28,43
3281,Anthony Allen,JR,2014-15,F,Oklahoma State,Big 12,25,179,16,21,16,21,0,0,10,23,16,45,61,4,3,19,22,36,42
3282,Christian Benzon,SO,2014-15,G,Evansville,MVC,31,232,12,33,12,30,0,3,18,24,7,29,36,12,5,1,18,22,42
3283,Justin Bibbins,FR,2014-15,G,Long Beach State,Big West,33,259,12,37,9,16,3,21,15,24,3,12,15,27,5,0,19,27,42
3284,Brandon Cataldo,SR,2014-15,C,Portland State,Big Sky,19,112,19,35,19,35,0,0,4,8,13,22,35,2,0,7,9,18,42
3285,Michael Chandler,JR,2014-15,C,Oregon,Pac-12,19,101,14,28,14,28,0,0,14,20,15,11,26,0,2,2,11,21,42
3286,Marcus Fuggins,JR,2014-15,F-C,Morehead State,OVC,28,241,16,39,16,38,0,1,10,32,27,30,57,5,11,14,22,66,42
3287,Alexander Aka Gorski,FR,2014-15,G,Wyoming,MWC,20,167,13,42,5,12,8,30,8,16,8,5,13,2,3,0,8,10,42
3288,Devon Hall,FR,2014-15,G,Virginia,ACC,23,244,16,40,11,25,5,15,5,11,2,15,17,18,9,1,12,18,42
3289,Shea Jones,SO,2014-15,G,Jacksonville,A-Sun,17,209,13,37,2,16,11,21,5,13,6,19,25,14,5,4,18,21,42
3290,Sharkaris Laney,FR,2014-15,G,Central Connecticut State,NEC,24,226,15,51,10,24,5,27,7,9,9,14,23,14,6,3,7,20,42
3291,Giovanni Mack,FR,2014-15,G,Texas Southern,SWAC,24,223,13,34,6,17,7,17,9,14,3,18,21,14,6,1,8,16,42
3292,Solomon Mangham,SO,2014-15,F-C,Howard,MEAC,24,166,15,46,8,24,7,22,5,8,18,17,35,5,3,2,8,15,42
3293,Tyshawn Myles,FR,2014-15,F,Drexel,CAA,27,314,17,44,17,44,0,0,8,16,40,52,92,5,4,14,8,42,42
3294,Marquis Nelson,FR,2014-15,G,Nicholls State,Southland,21,210,16,46,8,24,8,22,2,8,5,13,18,10,4,2,19,22,42
3295,Isiah Patterson,SO,2014-15,G,Grambling,SWAC,27,175,13,40,4,15,9,25,7,10,3,11,14,8,4,0,10,7,42
3296,Trey Patterson,FR,2014-15,G,Houston Baptist,Southland,20,188,15,27,15,23,0,4,12,23,4,8,12,16,11,0,22,31,42
3297,Desmond Ridenour,SO,2014-15,G,Duquesne,A-10,21,166,14,38,8,21,6,17,8,18,3,12,15,17,9,0,15,22,42
3298,Troy Simmons,SR,2014-15,G,Bethune-Cookman,MEAC,27,369,12,34,9,26,3,8,15,20,2,20,22,32,14,2,27,29,42
3299,Patrick Triplett,FR,2014-15,G,Brown,Ivy,23,178,12,47,8,26,4,21,14,20,4,23,27,13,1,3,22,14,42
3300,Ishmail Wainright,SO,2014-15,G-F,Baylor,Big 12,31,298,11,28,9,18,2,10,18,25,20,34,54,24,6,1,16,33,42
3301,Kevin Zabo,FR,2014-15,G,San Diego State,MWC,16,175,14,39,9,25,5,14,9,16,3,13,16,9,5,0,15,12,42
3302,Deuce Bello,JR,2014-15,G,Missouri,SEC,23,251,16,42,12,26,4,16,5,15,5,20,25,9,6,5,18,40,41
3303,Ojai Black,SO,2014-15,G,Texas State,Sun Belt,31,377,12,41,8,27,4,14,13,17,5,23,28,23,11,2,21,32,41
3304,Trey Dickerson,SO,2014-15,G,Iowa,Big Ten,15,146,17,49,13,36,4,13,3,10,1,6,7,18,7,0,15,15,41
3305,Victor Dorsey,FR,2014-15,F,Longwood,Big South,24,221,17,41,17,40,0,1,7,11,14,25,39,4,4,5,13,32,41
3306,Kahlil Dukes,SO,2014-15,G,Southern California,Pac-12,20,144,16,40,8,21,8,19,1,2,1,4,5,4,1,0,3,11,41
3307,DeLovell Earls,SR,2014-15,F,Air Force,MWC,19,222,15,37,14,30,1,7,10,16,10,25,35,30,10,2,16,41,41
3308,Chaz Glotta,FR,2014-15,G,Southern Illinois,MVC,19,127,11,38,3,8,8,30,11,13,1,3,4,4,7,0,6,19,41
3309,Austin Henry,FR,2014-15,F,Incarnate Word,Southland,28,231,18,56,16,49,2,7,3,8,15,26,41,3,3,7,5,42,41
3310,Rahjan Muhammad,SR,2014-15,G,Chicago State,WAC,12,89,15,37,11,22,4,15,7,9,3,11,14,2,9,0,10,8,41
3311,Gavin Skelly,FR,2014-15,F,Northwestern,Big Ten,29,210,16,33,16,33,0,0,9,17,23,31,54,14,9,16,9,36,41
3312,Ryan Andrus,FR,2014-15,F,Brigham Young,WCC,21,157,12,22,9,14,3,8,13,18,12,16,28,3,4,2,5,24,40
3313,Jordan Barnett,FR,2014-15,F,Texas,Big 12,21,179,15,45,8,24,7,21,3,3,5,23,28,10,7,6,9,11,40
3314,Cole Harrison,SO,2014-15,C,Dartmouth,Ivy,27,149,18,36,18,36,0,0,4,12,9,22,31,2,2,6,15,35,40
3315,Kevin Holland,FR,2014-15,G,Southern Mississippi,CUSA,29,562,15,58,7,16,8,42,2,5,0,42,42,48,18,0,39,24,40
3316,Tre' Ivory,FR,2014-15,G,Austin Peay,OVC,21,237,13,51,6,31,7,20,7,15,3,14,17,18,8,1,13,21,40
3317,Dontay Jackson,JR,2014-15,G,Jacksonville State,OVC,28,336,14,37,14,32,0,5,12,34,7,40,47,34,16,2,29,35,40
3318,Paul Jackson,FR,2014-15,G,Eastern Kentucky,OVC,24,250,15,40,12,28,3,12,7,15,2,12,14,41,11,0,15,33,40
3319,Milos Kostic,FR,2014-15,F,Appalachian State,Sun Belt,21,146,14,44,8,17,6,27,6,8,12,17,29,7,3,1,8,11,40
3320,Tony Kynard,SO,2014-15,G,Bethune-Cookman,MEAC,11,204,15,57,14,46,1,11,9,12,8,8,16,30,12,0,20,24,40
3321,Garrett Moon,SR,2014-15,F,Eastern Washington,Big Sky,31,176,19,34,18,32,1,2,1,6,20,17,37,3,6,14,11,33,40
3322,Anthony Mosley,FR,2014-15,G,Delaware,CAA,26,224,11,37,10,33,1,4,17,33,6,12,18,36,11,3,23,26,40
3323,Ryan Singer,FR,2014-15,F,San Jose State,MWC,28,401,11,43,7,19,4,24,14,23,24,31,55,9,5,8,15,57,40
3324,Sebastian Suarez,JR,2014-15,G,Portland State,Big Sky,14,142,14,33,7,16,7,17,5,6,5,9,14,7,6,5,6,8,40
3325,Matt Taylor,FR,2014-15,G,New Mexico State,WAC,26,220,15,36,14,30,1,6,9,16,16,23,39,14,5,1,16,24,40
3326,Joe Thomas,SR,2014-15,F,Miami (FL),ACC,31,328,18,31,18,31,0,0,4,14,32,33,65,9,7,4,7,33,40
3327,Kellon Thomas,JR,2014-15,G,Kent State,MAC,8,138,12,42,10,28,2,14,14,19,0,10,10,10,6,0,10,13,40
3328,Greg White-Pittman,FR,2014-15,G,North Texas,CUSA,17,155,11,36,11,26,0,10,18,31,2,6,8,6,3,0,15,22,40
3329,Alec Wnuk,FR,2014-15,F,North Carolina-Asheville,Big South,15,122,16,38,15,36,1,2,7,14,11,20,31,5,2,2,3,22,40
3330,Turner Botz,SO,2014-15,G,Green Bay,Horizon,29,235,11,39,4,11,7,28,10,13,7,15,22,6,1,1,6,20,39
3331,Darian Bryant,FR,2014-15,G,George Washington,A-10,32,172,14,39,11,29,3,10,8,13,8,17,25,6,3,0,9,16,39
3332,Brent Calhoun,SO,2014-15,F,IPFW,Summit,17,134,15,34,15,34,0,0,9,17,12,30,42,2,1,10,14,29,39
3333,Tyler Corley,JR,2014-15,G,Mississippi Valley State,SWAC,7,110,12,43,9,30,3,13,12,18,3,3,6,7,4,0,9,6,39
3334,Lawrence Fejokwu,JR,2014-15,C,Coppin State,MEAC,29,284,16,40,16,40,0,0,7,20,22,35,57,7,14,14,17,57,39
3335,Tevin Glass,JR,2014-15,F,Wichita State,MVC,19,107,12,31,9,25,3,6,12,15,11,10,21,4,1,3,5,15,39
3336,Terrell Hales,FR,2014-15,G,Cleveland State,Horizon,31,324,12,25,11,19,1,6,14,18,22,25,47,18,23,1,14,32,39
3337,Petr Herman,FR,2014-15,F,Loyola Marymount,WCC,28,272,13,48,7,27,6,21,7,10,7,30,37,6,8,5,16,28,39
3338,Bennett Koch,FR,2014-15,F,Northern Iowa,MVC,28,115,15,28,15,28,0,0,9,17,8,9,17,0,0,3,9,23,39
3339,Ethan Mackey,JR,2014-15,F,Maine,AEC,9,116,17,31,17,31,0,0,5,10,9,18,27,5,0,2,7,13,39
3340,Omar El Manasterly,SO,2014-15,F,Jacksonville,A-Sun,26,321,13,31,13,31,0,0,13,28,31,39,70,7,9,0,12,46,39
3341,Ryan Manning,FR,2014-15,F,Air Force,MWC,28,219,13,40,7,16,6,24,7,12,13,20,33,10,2,3,7,22,39
3342,Milan Mijovic,FR,2014-15,F,Marshall,CUSA,28,209,14,24,14,24,0,0,11,18,16,19,35,4,6,0,17,46,39
3343,Glen Pierre,SO,2014-15,F-C,College of Charleston,CAA,32,281,13,38,13,38,0,0,13,18,20,37,57,1,5,21,14,48,39
3344,Angus Riley,FR,2014-15,F-C,Bryant,NEC,17,177,14,43,7,17,7,26,4,8,8,21,29,5,1,0,5,15,39
3345,James Ringholdt,FR,2014-15,C,Texas-San Antonio,CUSA,28,284,13,41,2,6,11,35,2,7,5,40,45,10,4,12,13,38,39
3346,Dezmyn Trent,SO,2014-15,G,Boise State,MWC,11,99,13,37,6,16,7,21,6,10,5,19,24,0,2,1,7,5,39
3347,Stephen Ugochukwu,FR,2014-15,F,McNeese State,Southland,27,195,16,48,16,41,0,7,7,15,13,32,45,3,2,9,9,28,39
3348,Trey Brown,SO,2014-15,G,North Carolina A&amp;T,MEAC,11,110,15,36,10,17,5,19,3,6,3,7,10,3,3,1,7,14,38
3349,Justin Dotson,SO,2014-15,G,Stephen F. Austin,Southland,19,102,13,33,11,21,2,12,10,17,2,17,19,8,10,3,12,12,38
3350,Grant Evans,FR,2014-15,G,Wright State,Horizon,21,241,14,57,5,20,9,37,1,4,4,14,18,15,7,0,15,27,38
3351,John Fenton,SO,2014-15,C,Colgate,Patriot,32,297,15,42,15,42,0,0,8,20,22,42,64,1,6,8,12,60,38
3352,Treyvon Francis,FR,2014-15,G,Savannah State,MEAC,29,454,14,67,11,33,3,34,7,15,9,25,34,19,29,5,34,36,38
3353,James Griffin,FR,2014-15,G,Marist,MAAC,19,203,12,44,9,17,3,27,11,14,4,20,24,4,5,0,29,24,38
3354,Mark Howell,SO,2014-15,G,Wright State,Horizon,26,231,11,38,9,23,2,15,14,17,2,10,12,20,9,0,11,13,38
3355,Jordan Jackson,FR,2014-15,F,Florida A&amp;M,MEAC,27,313,15,44,15,44,0,0,8,18,20,24,44,7,4,7,23,38,38
3356,Scott Kingsley,SO,2014-15,G,Fairleigh Dickinson,NEC,23,150,13,45,10,25,3,20,9,15,7,8,15,3,5,0,9,16,38
3357,Dave LaMore,SR,2014-15,F-C,Cornell,Ivy,17,229,17,28,17,28,0,0,4,10,16,31,47,2,0,6,8,31,38
3358,Nate Maxey,JR,2014-15,C,North Carolina Central,MEAC,25,194,14,22,14,22,0,0,10,21,13,32,45,0,2,42,16,45,38
3359,Mikhail McLean,SR,2014-15,F,Houston,AAC,15,149,16,36,16,33,0,3,6,18,17,9,26,7,2,3,4,29,38
3360,Deverin Muff,JR,2014-15,F,Eastern Kentucky,OVC,32,354,15,36,15,36,0,0,8,10,15,24,39,5,18,18,7,58,38
3361,Jeremy Olsen,JR,2014-15,C,Utah,Pac-12,24,153,14,35,14,35,0,0,10,20,7,26,33,1,2,5,12,21,38
3362,Darryl Reynolds,SO,2014-15,F,Villanova,Big East,27,145,15,21,15,21,0,0,8,20,10,21,31,5,4,14,9,27,38
3363,Mitchell Solomon,SR,2014-15,F,Oklahoma State,Big 12,32,348,14,30,13,28,1,2,9,17,42,44,86,11,11,19,16,71,38
3364,Clive Vaughan,FR,2014-15,G,Morgan State,MEAC,20,123,14,60,5,15,9,45,1,3,5,5,10,1,5,1,5,9,38
3365,Aaron Young,FR,2014-15,G,Princeton,Ivy,15,68,12,21,0,0,12,21,2,2,0,3,3,2,1,1,4,14,38
3366,Jefkin Agyeman-Budu,FR,2014-15,G,Grambling,SWAC,27,262,13,53,7,38,6,15,5,13,12,14,26,7,11,1,33,32,37
3367,Amar Alibegovic,FR,2014-15,F,St. John's (NY),Big East,24,201,15,43,9,17,6,26,1,7,13,24,37,3,4,3,9,42,37
3368,Aaron Ariri,FR,2014-15,F-C,Troy,Sun Belt,29,294,13,44,13,43,0,1,11,26,35,49,84,3,4,8,19,29,37
3369,Alex Bates,SO,2014-15,F,East Tennessee State,Southern,25,286,16,31,16,30,0,1,5,15,28,30,58,6,12,13,14,50,37
3370,Armani Branch,FR,2014-15,G,Virginia Military Institute,Southern,15,83,16,44,13,21,3,23,2,7,5,10,15,6,6,5,5,6,37
3371,Dayon Griffin,FR,2014-15,G,Louisiana Tech,CUSA,28,183,15,29,10,19,5,10,2,12,3,24,27,5,11,6,14,15,37
3372,Kuran Iverson,SO,2014-15,F-G,Memphis,AAC,8,94,13,26,11,21,2,5,9,12,6,9,15,8,3,4,13,15,37
3373,Elston Jones,FR,2014-15,F,Utah State,MWC,28,269,15,34,15,34,0,0,7,15,17,38,55,17,6,12,8,44,37
3374,Earl McLaurin,SR,2014-15,G,Navy,Patriot,26,214,11,29,5,12,6,17,9,13,6,18,24,25,10,0,11,18,37
3375,Holden Mobley,SR,2014-15,G-F,Belmont,OVC,33,332,10,28,4,10,6,18,11,15,8,19,27,14,8,0,16,40,37
3376,Sean O'Mara,FR,2014-15,F-C,Xavier,Big East,25,106,14,25,14,25,0,0,9,19,9,8,17,5,2,7,4,16,37
3377,Jason Pimentel,JR,2014-15,F,Longwood,Big South,8,157,14,27,12,22,2,5,7,9,10,25,35,3,4,6,6,23,37
3378,Lane Severyn,FR,2014-15,G-F,South Dakota State,Summit,25,199,12,39,3,5,9,34,4,8,11,33,44,13,11,3,9,20,37
3379,Jerome Simmons,SO,2014-15,C-F,North Carolina A&amp;T,MEAC,23,161,16,31,16,31,0,0,5,8,10,17,27,0,0,4,5,28,37
3380,Jordan Abdur-Ra'oof,FR,2014-15,F,Cornell,Ivy,27,173,13,40,7,24,6,16,4,5,2,14,16,4,5,4,4,24,36
3381,Dallas Anglin,JR,2014-15,G,Southern Mississippi,CUSA,6,99,8,20,2,7,6,13,14,15,0,6,6,9,5,0,3,8,36
3382,Alex Carr,JR,2014-15,G,Utah Valley,WAC,30,386,13,55,4,15,9,40,1,4,4,36,40,14,9,2,12,40,36
3383,Andre Chatfield,FR,2014-15,G,Harvard,Ivy,21,192,12,28,9,14,3,14,9,12,6,19,25,10,12,1,10,15,36
3384,Christian Crockett,JR,2014-15,F,Tennessee State,OVC,19,164,11,38,11,35,0,3,14,38,8,26,34,3,3,0,8,26,36
3385,Chad Donley,SR,2014-15,G,Morehead State,OVC,15,115,11,31,1,5,10,26,4,9,4,10,14,5,0,0,5,14,36
3386,Kedrick Flomo,FR,2014-15,G,Murray State,OVC,29,312,10,53,1,18,9,35,7,10,3,27,30,30,10,4,22,30,36
3387,Martinas Geben,FR,2014-15,F,Notre Dame,ACC,22,194,11,20,11,20,0,0,14,20,9,26,35,9,1,8,13,23,36
3388,Kenny Paul Geno,SO,2014-15,F,Georgia,SEC,22,251,13,31,11,22,2,9,8,13,9,24,33,8,6,4,8,27,36
3389,Charles Hill,JR,2014-15,G,Texas Christian,Big 12,14,74,11,38,6,20,5,18,9,16,3,14,17,4,2,3,9,15,36
3390,Miroslav Jaksic,FR,2014-15,F,Grand Canyon,WAC,13,74,15,29,15,27,0,2,6,13,5,11,16,0,0,4,8,14,36
3391,Cameron Johnson,FR,2014-15,G,Pittsburgh,ACC,8,115,13,33,5,10,8,23,2,4,2,7,9,4,1,3,4,12,36
3392,Mike Kobani,FR,2014-15,F,Appalachian State,Sun Belt,21,127,14,31,14,31,0,0,8,19,10,15,25,1,1,2,5,27,36
3393,Cameron Neubauer,FR,2014-15,F,San Diego,WCC,17,152,13,31,6,14,7,17,3,9,5,11,16,2,3,2,3,11,36
3394,Miles Overton,SO,2014-15,G,Wake Forest,ACC,7,89,9,28,4,10,5,18,13,15,1,11,12,3,3,1,11,11,36
3395,Julius Rajala,FR,2014-15,F,Loyola (IL),MVC,19,119,14,30,13,28,1,2,7,11,8,13,21,2,2,5,10,8,36
3396,Johnathan Spicer,FR,2014-15,F,Florida A&amp;M,MEAC,28,267,11,34,10,26,1,8,13,20,11,28,39,8,5,0,21,13,36
3397,Evan Wardlow,FR,2014-15,F,Santa Clara,WCC,30,272,15,34,14,31,1,3,5,6,2,21,23,16,4,2,15,19,36
3398,Prince Williams,JR,2014-15,G,East Carolina,AAC,23,233,12,37,11,27,1,10,11,13,4,20,24,22,8,2,17,21,36
3399,Colby Wollenman,JR,2014-15,F,Michigan State,Big Ten,29,220,17,28,17,28,0,0,2,9,14,35,49,6,3,4,12,27,36
3400,Moses Abraham,SR,2014-15,C,Nebraska,Big Ten,22,225,15,30,15,30,0,0,5,11,32,43,75,2,5,10,20,45,35
3401,Chris Dees,SR,2014-15,F-C,St. Bonaventure,A-10,31,294,16,42,16,42,0,0,3,6,18,43,61,5,13,10,5,45,35
3402,Taylor Echols,SR,2014-15,G,Georgia,SEC,25,162,11,32,0,1,11,31,2,6,0,13,13,4,3,0,12,15,35
3403,Cameron Fowler,SO,2014-15,G,Niagara,MAAC,24,241,13,38,8,26,5,12,4,12,7,20,27,19,12,0,13,33,35
3404,James Hemphill,SO,2014-15,F,Navy,Patriot,15,156,14,22,14,22,0,0,7,11,9,19,28,5,4,0,7,11,35
3405,Anthony Johnson,SO,2014-15,G,Eastern Illinois,OVC,23,145,14,23,12,15,2,8,5,12,6,20,26,4,4,0,7,12,35
3406,Tom Koopman,SO,2014-15,C,Citadel,Southern,21,155,13,26,13,26,0,0,9,10,11,18,29,4,6,4,9,22,35
3407,Justin Lobell,FR,2014-15,G,Southeastern Louisiana,Southland,15,161,12,27,1,3,11,24,0,0,3,13,16,4,4,0,4,7,35
3408,Anas Mahmoud,FR,2014-15,F,Louisville,ACC,30,236,13,25,13,25,0,0,9,12,17,24,41,11,4,20,14,30,35
3409,Jabari McGhee,FR,2014-15,F,Tennessee,SEC,8,103,14,20,14,20,0,0,7,17,16,14,30,0,3,1,3,24,35
3410,Erik Nakken,FR,2014-15,G,Idaho State,Big Sky,20,107,11,32,0,1,11,31,2,4,0,1,1,4,2,1,3,6,35
3411,Hugo Naurais,SR,2014-15,F,Wagner,NEC,25,250,16,49,16,37,0,12,3,6,22,34,56,4,6,9,16,35,35
3412,Avery Patterson,FR,2014-15,G,Western Kentucky,CUSA,20,108,12,29,6,10,6,19,5,8,0,12,12,9,5,0,20,11,35
3413,Oskar Reinfelds,JR,2014-15,G,Troy,Sun Belt,9,113,11,28,8,17,3,11,10,15,2,8,10,11,4,0,10,10,35
3414,Derrell Robertson,JR,2014-15,C,San Francisco,WCC,24,205,13,31,13,31,0,0,9,16,16,18,34,4,1,11,20,53,35
3415,Issac Smith,SR,2014-15,G,Maryland-Eastern Shore,MEAC,28,341,10,46,7,30,3,16,12,23,3,19,22,44,10,0,37,24,35
3416,Brian Steele,JR,2014-15,F,South Carolina,SEC,21,179,11,47,2,9,9,38,4,4,2,10,12,8,7,1,5,20,35
3417,Manny Suarez,FR,2014-15,F,Fordham,A-10,19,143,12,52,5,24,7,28,4,6,10,30,40,3,3,18,12,26,35
3418,Nenad Tomic,SR,2014-15,F,Cornell,Ivy,23,147,10,31,10,31,0,0,15,23,15,9,24,2,2,0,3,16,35
3419,Bush Wamukota,JR,2014-15,C,Wichita State,MVC,32,192,10,22,10,22,0,0,15,28,19,29,48,1,2,5,8,36,35
3420,Devonte Boykins,FR,2014-15,G,Georgia Southern,Sun Belt,25,154,12,25,7,10,5,15,5,6,3,17,20,15,6,0,7,16,34
3421,Chris Braley,SO,2014-15,G-F,Stony Brook,AEC,23,211,14,38,10,19,4,19,2,5,12,33,45,11,5,2,13,23,34
3422,Austin Burgett,JR,2014-15,F,Notre Dame,ACC,20,139,15,27,14,16,1,11,3,6,7,21,28,7,6,1,7,21,34
3423,Ryan Burnett,SO,2014-15,G,Stony Brook,AEC,15,123,13,32,10,15,3,17,5,8,10,2,12,10,0,0,8,7,34
3424,Wesley Dickinson,SO,2014-15,F,Dartmouth,Ivy,27,190,15,30,15,30,0,0,4,9,14,16,30,2,2,11,11,18,34
3425,Nick Fuller,FR,2014-15,F,Nebraska,Big Ten,16,129,13,25,10,17,3,8,5,6,8,13,21,4,2,2,4,12,34
3426,Josh Hearlihy,SO,2014-15,G-F,Tulane,AAC,22,186,13,39,9,25,4,14,4,12,15,18,33,13,6,1,13,22,34
3427,Hayden Hunter,FR,2014-15,G,Weber State,Big Sky,28,387,5,28,1,16,4,12,20,28,6,30,36,59,7,0,35,39,34
3428,Chad Johnson,SR,2014-15,G,Lipscomb,A-Sun,30,253,9,26,4,12,5,14,11,14,2,30,32,21,11,1,14,36,34
3429,Jeremy Lieberman,FR,2014-15,G,Wyoming,MWC,25,224,11,41,6,14,5,27,7,10,3,11,14,20,9,1,12,18,34
3430,Marcus Mathieu,FR,2014-15,G,McNeese State,Southland,28,196,11,40,7,22,4,18,8,14,2,7,9,16,3,0,17,26,34
3431,Eric McClellan,JR,2014-15,G,Gonzaga,WCC,18,145,8,24,5,16,3,8,15,24,4,12,16,14,3,1,4,11,34
3432,Kerwin Okoro,JR,2014-15,G-F,Rutgers,Big Ten,17,124,12,42,8,22,4,20,6,6,6,9,15,8,2,0,12,13,34
3433,Tariq Owens,FR,2014-15,F,Tennessee,SEC,28,214,12,34,12,34,0,0,10,19,14,17,31,3,5,13,11,40,34
3434,Ryan Salmonson,SR,2014-15,C,North Dakota,Big Sky,15,124,14,28,14,28,0,0,6,6,4,14,18,1,3,2,14,30,34
3435,Michael Schlotman,FR,2014-15,G,William &amp; Mary,CAA,24,231,8,24,6,21,2,3,16,25,4,10,14,17,7,1,13,24,34
3436,Coye Simmons,FR,2014-15,F,Georgia Southern,Sun Belt,19,98,14,26,14,26,0,0,6,13,16,25,41,0,1,2,3,13,34
3437,Jakob Stenhede,FR,2014-15,F,Maryland-Baltimore County,AEC,27,201,13,26,13,26,0,0,8,14,12,28,40,1,2,6,6,25,34
3438,Andreas Bigum,JR,2014-15,F,Texas-Pan American,WAC,29,329,12,40,12,39,0,1,9,22,13,23,36,17,3,6,24,57,33
3439,Alec Brennan,FR,2014-15,F,Princeton,Ivy,23,151,11,27,8,18,3,9,8,12,9,13,22,8,3,7,10,32,33
3440,Matthew Butler,SO,2014-15,G,Rhode Island,A-10,20,147,12,34,5,14,7,20,2,2,1,14,15,6,2,0,13,12,33
3441,Pierre Crawford,SR,2014-15,C,Jackson State,SWAC,22,124,13,27,13,27,0,0,7,18,11,15,26,2,2,5,13,29,33
3442,Alex Hart,SO,2014-15,F,California-Santa Barbara,Big West,12,79,10,22,5,9,5,13,8,11,8,10,18,6,0,0,4,10,33
3443,Phillip Johnson,SO,2014-15,G,Incarnate Word,Southland,23,237,14,27,14,26,0,1,5,10,5,13,18,5,7,1,6,21,33
3444,Frederik Jorg,SO,2014-15,F,Eastern Washington,Big Sky,15,68,13,19,13,19,0,0,7,12,8,9,17,3,0,5,5,19,33
3445,Kurt Karis,SO,2014-15,G,Chicago State,WAC,21,294,12,43,12,37,0,6,9,14,11,34,45,32,12,0,22,32,33
3446,Marquiez Lawrence,SO,2014-15,F,Kent State,MAC,31,289,13,27,13,27,0,0,7,15,24,43,67,6,7,11,21,74,33
3447,K.J. Maura,FR,2014-15,G,Abilene Christian,Southland,17,195,11,32,5,14,6,18,5,5,7,17,24,30,9,0,15,15,33
3448,Tanner Omlid,SO,2014-15,F,Army,Patriot,5,75,15,36,14,26,1,10,2,4,11,18,29,11,11,7,3,18,33
3449,Alex Peters,FR,2014-15,F-C,Samford,Southern,31,287,16,29,16,29,0,0,1,4,13,26,39,3,8,12,19,76,33
3450,Kaileb Rodriguez,SO,2014-15,F,Nevada,MWC,30,422,13,51,13,51,0,0,7,14,17,56,73,10,2,11,24,64,33
3451,Scott Sill,SO,2014-15,F,Delaware State,MEAC,24,150,12,36,4,13,8,23,1,5,8,18,26,3,3,3,8,20,33
3452,Idris Taqqee,FR,2014-15,G,St. Bonaventure,A-10,27,225,12,39,11,24,1,15,8,18,13,22,35,14,8,0,10,29,33
3453,Chris Thomas,FR,2014-15,G,Southern,SWAC,21,147,13,32,10,21,3,11,4,13,4,17,21,5,2,2,8,22,33
3454,T.J. Thomas,FR,2014-15,F,Southeast Missouri State,OVC,15,120,9,19,9,19,0,0,15,20,12,12,24,4,2,4,7,17,33
3455,Andre Washington,JR,2014-15,C,Wake Forest,ACC,21,103,11,24,11,24,0,0,11,15,9,9,18,1,3,14,5,25,33
3456,Jabbar Washington,JR,2014-15,G,Charleston Southern,Big South,21,141,12,34,7,19,5,15,4,10,2,13,15,9,5,2,4,12,33
3457,Javon Bess,FR,2014-15,F,Michigan State,Big Ten,12,148,11,23,10,21,1,2,9,21,15,20,35,12,4,3,9,16,32
3458,Milos Cabarkapa,FR,2014-15,G-F,Central Michigan,MAC,23,97,12,20,12,20,0,0,8,12,10,17,27,0,0,3,8,15,32
3459,Eric Carter,FR,2014-15,F,Delaware,CAA,23,218,12,34,12,34,0,0,8,17,29,28,57,12,4,8,20,42,32
3460,John Edwards,SO,2014-15,F,New Hampshire,AEC,7,78,9,18,8,14,1,4,13,15,0,5,5,4,1,0,5,8,32
3461,Jordan Garnett,FR,2014-15,F,Northern Kentucky,A-Sun,17,108,10,23,10,19,0,4,12,23,13,9,22,3,2,1,8,15,32
3462,Sean Goodwin,JR,2014-15,F,Sam Houston State,Southland,17,87,10,15,10,15,0,0,12,18,11,12,23,9,3,0,3,12,32
3463,Jack Hobbs,SO,2014-15,F,Hartford,AEC,14,158,12,33,4,6,8,27,0,4,5,21,26,4,4,3,3,14,32
3464,Jonathan Hood,JR,2014-15,G,Eastern Kentucky,OVC,13,100,11,37,3,9,8,28,2,2,3,7,10,6,4,0,3,4,32
3465,J.T. Jones,FR,2014-15,G,Southeast Missouri State,OVC,13,101,13,29,9,17,4,12,2,4,9,10,19,7,1,0,8,16,32
3466,Joe Kuligoski,SO,2014-15,G-F,Jacksonville State,OVC,26,252,10,31,7,17,3,14,9,12,22,42,64,9,2,3,7,29,32
3467,Uros Ljeskovic,JR,2014-15,F,Coastal Carolina,Big South,8,91,11,21,11,21,0,0,10,17,13,13,26,2,3,0,7,6,32
3468,Jakub Petras,FR,2014-15,F,Stony Brook,AEC,28,195,14,32,14,32,0,0,4,8,20,22,42,4,3,4,10,29,32
3469,Will Ransom,JR,2014-15,F,Illinois State,MVC,25,232,13,22,13,21,0,1,6,9,19,30,49,4,6,7,14,38,32
3470,Kyle Reid,JR,2014-15,F,Eastern Washington,Big Sky,31,198,14,28,14,27,0,1,4,9,10,27,37,5,6,8,11,29,32
3471,Burton Sampson,FR,2014-15,G,Belmont,OVC,19,72,9,20,4,10,5,10,9,11,2,1,3,1,1,0,4,6,32
3472,Josh Sharp,SR,2014-15,F,Brigham Young,WCC,23,238,12,21,10,17,2,4,6,9,26,28,54,16,8,10,6,38,32
3473,Pat Smith,FR,2014-15,G-F,Cornell,Ivy,12,99,11,30,6,13,5,17,5,6,2,5,7,5,1,1,1,9,32
3474,Lew Stallworth,FR,2014-15,G,Texas-El Paso,CUSA,19,151,9,31,7,21,2,10,12,14,1,12,13,10,2,3,10,11,32
3475,Mike Turner,JR,2014-15,G,Houston Baptist,Southland,15,80,11,29,4,7,7,22,3,6,2,4,6,4,0,0,8,2,32
3476,Jordan Wells,SO,2014-15,F,McNeese State,Southland,18,102,14,24,14,24,0,0,4,9,12,10,22,1,1,2,9,23,32
3477,Robert Wiley,FR,2014-15,G,Grambling,SWAC,26,261,13,47,12,36,1,11,5,11,5,19,24,9,8,4,30,36,32
3478,Drew Bender,SO,2014-15,G,Northern Colorado,Big Sky,9,48,10,17,3,3,7,14,4,4,1,4,5,3,3,0,1,6,31
3479,Jason Boswell,SO,2014-15,G,Florida International,CUSA,29,319,11,51,8,31,3,20,6,9,4,18,22,19,10,2,32,38,31
3480,Brendan Casper,SO,2014-15,F,Saint Joseph's,A-10,23,108,13,34,12,25,1,9,4,11,12,21,33,5,6,2,11,22,31
3481,Dean Danos,SO,2014-15,G,Northern Kentucky,A-Sun,19,114,8,29,1,5,7,24,8,8,2,8,10,9,0,1,6,11,31
3482,Andre Frederick,FR,2014-15,F,Robert Morris,NEC,24,179,14,26,14,26,0,0,3,5,12,19,31,2,5,14,8,20,31
3483,Jamil Hood,FR,2014-15,G,Long Island University,NEC,24,174,10,29,10,21,0,8,11,16,4,22,26,6,4,1,13,19,31
3484,Wesley Johnson,FR,2014-15,F,Charleston Southern,Big South,24,158,11,23,11,23,0,0,9,26,15,12,27,2,4,6,5,26,31
3485,Dylan Karell,JR,2014-15,F,Central Florida,AAC,29,283,12,25,12,25,0,0,7,20,16,29,45,10,8,9,15,38,31
3486,A.J. Lapray,FR,2014-15,G,Pepperdine,WCC,18,205,11,43,6,15,5,28,4,7,2,16,18,5,6,4,12,26,31
3487,Jesse Lopez,FR,2014-15,F,Sam Houston State,Southland,19,104,14,34,13,29,1,5,2,3,8,15,23,5,3,1,6,15,31
3488,Daniel Meyer,FR,2014-15,F,Nebraska-Omaha,Summit,21,97,12,27,12,27,0,0,7,11,9,22,31,1,1,4,2,5,31
3489,Niklas Ney,FR,2014-15,F,Mercer,Southern,22,107,9,20,9,20,0,0,13,17,10,9,19,1,0,1,5,15,31
3490,Kraig Shields,FR,2014-15,F,North Dakota,Big Sky,17,139,12,22,12,22,0,0,7,10,6,24,30,2,2,9,5,21,31
3491,Ramel Thompkins,FR,2014-15,F,South Carolina Upstate,A-Sun,16,138,12,34,8,10,4,24,3,11,10,26,36,10,1,3,1,8,31
3492,Oliver Tot,FR,2014-15,G,William &amp; Mary,CAA,24,222,9,22,7,14,2,8,11,17,5,21,26,27,11,3,21,19,31
3493,Joseph Uchebo,JR,2014-15,C,Pittsburgh,ACC,21,130,14,36,14,36,0,0,3,4,15,25,40,3,1,2,6,18,31
3494,Michael Williams,SO,2014-15,G,Texas Christian,Big 12,17,83,11,18,7,11,4,7,5,10,2,9,11,9,1,0,2,5,31
3495,C.J. Anderson,FR,2014-15,G,Massachusetts,A-10,29,293,10,30,7,17,3,13,7,10,10,31,41,17,9,2,11,41,30
3496,Nate Austin,SR,2014-15,F,Brigham Young,WCC,10,197,9,18,8,13,1,5,11,14,15,41,56,9,7,2,3,22,30
3497,Jordan Brown,SO,2014-15,G,Arkansas-Pine Bluff,SWAC,21,156,13,27,13,27,0,0,4,7,16,17,33,4,3,1,5,15,30
3498,Zachary Hollis,JR,2014-15,F-C,Lamar,Southland,21,209,10,34,10,34,0,0,10,16,17,34,51,6,2,4,11,33,30
3499,Kerem Kanter,FR,2014-15,F,Green Bay,Horizon,19,82,13,24,11,17,2,7,2,5,6,12,18,3,2,2,5,10,30
3500,Breon Key,JR,2014-15,G,Hampton,MEAC,21,159,10,20,9,15,1,5,9,14,4,10,14,10,8,0,3,20,30
3501,Haroldas Saprykinas,FR,2014-15,G,California-Irvine,Big West,16,62,8,15,3,6,5,9,9,14,0,4,4,2,0,0,2,3,30
3502,Anthony Silvestri,SR,2014-15,F,Cal Poly,Big West,24,226,9,59,3,10,6,49,6,8,10,22,32,2,2,0,5,23,30
3503,Shaqquan Aaron,FR,2014-15,G,Louisville,ACC,23,166,11,42,6,19,5,23,2,5,6,11,17,5,3,2,8,11,29
3504,Dionte Adams,JR,2014-15,F,Hampton,MEAC,21,183,10,28,10,28,0,0,9,11,18,25,43,6,8,9,11,26,29
3505,Luka Andjusic,FR,2014-15,G,South Alabama,Sun Belt,18,140,9,33,1,5,8,28,3,3,2,16,18,6,2,0,5,11,29
3506,Felix Balamou,JR,2014-15,G,St. John's (NY),Big East,22,203,11,36,11,36,0,0,7,11,14,15,29,4,6,1,14,28,29
3507,Rohan Brown,JR,2014-15,G-F,La Salle,A-10,28,210,11,23,7,11,4,12,3,6,18,26,44,7,6,4,9,9,29
3508,Hunter Ford,SO,2014-15,G,California-Santa Barbara,Big West,13,67,10,18,2,2,8,16,1,2,7,3,10,6,1,1,1,3,29
3509,Boston Gubler,FR,2014-15,F,Utah Valley,WAC,27,252,11,37,11,37,0,0,7,13,15,32,47,11,3,6,19,29,29
3510,Darrious Hamilton,JR,2014-15,F,Utah Valley,WAC,25,174,10,39,10,39,0,0,9,13,7,19,26,5,0,4,13,21,29
3511,Dominique Hawkins,SO,2014-15,G,Kentucky,SEC,23,163,10,35,5,14,5,21,4,10,3,13,16,14,7,1,5,14,29
3512,Nate Hickman,FR,2014-15,G,Columbia,Ivy,19,131,8,33,5,17,3,16,10,13,5,11,16,3,6,3,12,16,29
3513,Jace Hogan,FR,2014-15,F,Navy,Patriot,8,94,11,34,11,32,0,2,7,9,8,10,18,5,4,1,7,5,29
3514,Hassan Hussein,FR,2014-15,F,Florida International,CUSA,12,83,12,17,12,17,0,0,5,6,5,6,11,0,0,2,3,10,29
3515,Josh Ivory,JR,2014-15,G,Towson,CAA,24,271,9,41,2,14,7,27,4,8,1,16,17,31,6,0,20,19,29
3516,Jaylen Johnson,FR,2014-15,F,Louisville,ACC,23,106,13,27,12,26,1,1,2,5,13,16,29,2,4,3,6,20,29
3517,Duol Mayot,JR,2014-15,F,South Dakota,Summit,26,138,10,24,10,24,0,0,9,18,10,17,27,2,2,1,6,16,29
3518,Shaun Noriega,GR,2014-15,G,Texas-Pan American,WAC,3,62,9,20,2,4,7,16,4,5,1,3,4,2,1,0,5,8,29
3519,Luke Norman,JR,2014-15,G,Eastern Illinois,OVC,21,246,11,19,4,5,7,14,0,0,2,16,18,16,7,1,9,18,29
3520,Sean O'Brien,FR,2014-15,G,Colgate,Patriot,32,256,10,42,3,10,7,32,2,3,6,24,30,11,7,1,15,35,29
3521,Uche Ofoegbu,SO,2014-15,F,San Francisco,WCC,14,88,9,20,8,16,1,4,10,20,6,13,19,4,3,1,5,14,29
3522,Remy Roberts-Burnett,SR,2014-15,G,Western Illinois,Summit,16,177,12,37,10,33,2,4,3,8,2,16,18,11,3,0,9,10,29
3523,Jalen Robinson,JR,2014-15,F-C,Dayton,A-10,9,138,11,38,10,30,1,8,6,12,11,11,22,7,6,2,6,10,29
3524,Eli Robison,SO,2014-15,G,Utah Valley,WAC,21,113,9,31,5,16,4,15,7,8,9,12,21,3,2,0,6,5,29
3525,C.J. Siples,FR,2014-15,G,Air Force,MWC,18,125,10,18,9,15,1,3,8,17,1,10,11,11,5,3,9,15,29
3526,Austin Waddoups,FR,2014-15,G,Southern Utah,Big Sky,16,132,10,27,3,11,7,16,2,5,1,13,14,11,0,1,6,18,29
3527,Karon Waller,JR,2014-15,G,Binghamton,AEC,23,185,10,33,6,15,4,18,5,9,4,27,31,4,5,0,5,8,29
3528,Dayshawn Watkins,SO,2014-15,G,Florida State,ACC,22,198,7,25,6,17,1,8,14,21,2,20,22,20,8,0,17,25,29
3529,Collin Weaver,SO,2014-15,G,Oakland,Horizon,17,86,10,30,3,5,7,25,2,2,3,13,16,3,4,0,3,7,29
3530,Kevin Alter,SR,2014-15,G,Navy,Patriot,15,71,9,19,3,3,6,16,4,6,0,5,5,5,2,0,1,3,28
3531,Bret Barclay,FR,2014-15,F,Southeastern Louisiana,Southland,29,148,11,27,10,24,1,3,5,6,11,14,25,3,2,2,8,21,28
3532,Brett Bowling,FR,2014-15,G,Marshall,CUSA,14,67,8,27,4,7,4,20,8,10,1,2,3,0,1,0,2,7,28
3533,Daniel Bridges,FR,2014-15,F,South Carolina Upstate,A-Sun,9,80,11,33,6,14,5,19,1,2,6,13,19,6,1,0,7,3,28
3534,David Chadwick,SR,2014-15,F,Valparaiso,Horizon,12,105,11,24,8,14,3,10,3,10,4,11,15,2,0,4,5,8,28
3535,Kevin Crawford,SO,2014-15,G,North Carolina Central,MEAC,18,93,10,15,10,15,0,0,8,9,1,5,6,24,8,0,6,12,28
3536,Nick Davidson,SO,2014-15,G,Valparaiso,Horizon,15,94,8,22,2,8,6,14,6,6,3,5,8,6,3,0,6,3,28
3537,Raasean Davis,FR,2014-15,F,Kent State,MAC,21,92,12,21,12,21,0,0,4,6,8,11,19,1,2,0,4,18,28
3538,Lionel Gomis,JR,2014-15,F,Robert Morris,NEC,27,259,10,33,10,33,0,0,8,17,15,27,42,5,4,2,12,58,28
3539,Keith Gray,JR,2014-15,F,Northern Illinois,MAC,27,205,8,20,8,20,0,0,12,19,19,22,41,1,5,2,13,41,28
3540,Brian Greene,SO,2014-15,G,Florida Gulf Coast,A-Sun,29,284,11,57,11,42,0,15,6,9,3,21,24,25,7,1,26,28,28
3541,Julian Harris,FR,2014-15,F,Texas-Arlington,Sun Belt,18,130,11,32,5,19,6,13,0,2,8,13,21,5,1,1,9,14,28
3542,A.J. John,FR,2014-15,F,Pepperdine,WCC,24,251,12,34,12,33,0,1,4,9,15,40,55,1,3,9,13,44,28
3543,Jerred Kite,SO,2014-15,F,Incarnate Word,Southland,21,159,13,21,13,21,0,0,2,6,13,21,34,7,8,5,4,21,28
3544,Telvin Marshall,JR,2014-15,G,Grambling,SWAC,5,97,13,40,13,29,0,11,2,4,4,10,14,2,2,0,4,5,28
3545,Daniel Noe,FR,2014-15,G,Navy,Patriot,7,93,11,34,7,13,4,21,2,3,6,10,16,3,3,1,6,7,28
3546,Jason Owens,JR,2014-15,F,Delaware State,MEAC,16,112,12,28,12,27,0,1,4,7,6,16,22,2,1,1,7,17,28
3547,Myles Stewart,FR,2014-15,G,St. John's (NY),Big East,20,96,10,33,2,6,8,27,0,0,1,7,8,2,2,3,3,10,28
3548,Justin Thomas,FR,2014-15,G,Jackson State,SWAC,27,252,8,16,8,16,0,0,12,20,12,18,30,6,6,0,17,67,28
3549,Von Washington,SO,2014-15,G,Western Michigan,MAC,14,76,10,29,2,5,8,24,0,1,1,6,7,2,3,0,1,4,28
3550,Joniah White,FR,2014-15,C,Louisiana Tech,CUSA,26,186,10,18,10,18,0,0,8,14,14,20,34,1,1,19,7,27,28
3551,Lawrence Brown,SO,2014-15,G,Mercer,Southern,29,148,10,22,10,21,0,1,7,11,14,17,31,5,3,6,7,15,27
3552,Reggie Cameron,SO,2014-15,F,Georgetown,Big East,23,105,8,29,3,5,5,24,6,7,1,6,7,5,1,2,6,7,27
3553,Deitrich Cole,FR,2014-15,F-C,Jacksonville State,OVC,20,196,11,29,11,28,0,1,5,11,11,17,28,6,2,12,11,42,27
3554,Ladarius Coleman,FR,2014-15,G-F,Southeast Missouri State,OVC,10,93,7,27,5,19,2,8,11,13,1,15,16,6,1,1,4,6,27
3555,Stephen Edwards,FR,2014-15,G,Santa Clara,WCC,20,130,9,26,8,18,1,8,8,14,0,10,10,5,1,0,18,3,27
3556,Ron Giplaye,SR,2014-15,F,East Tennessee State,Southern,6,110,12,25,12,25,0,0,3,17,20,22,42,4,4,6,6,14,27
3557,Dan Kingma,FR,2014-15,G,Washington,Pac-12,10,65,8,18,1,4,7,14,4,7,2,4,6,1,1,0,1,6,27
3558,Joshua Phillips,SO,2014-15,F,Middle Tennessee,CUSA,17,151,8,27,8,27,0,0,11,18,12,17,29,5,3,5,10,19,27
3559,Eli Stalzer,JR,2014-15,G,Colorado,Pac-12,19,113,10,27,4,9,6,18,1,3,2,9,11,5,5,1,6,6,27
3560,Ron Trapps,SO,2014-15,G,Coastal Carolina,Big South,8,30,9,20,4,5,5,15,4,6,0,5,5,1,1,0,4,5,27
3561,Rashed Anthony,FR,2014-15,F,Seton Hall,Big East,30,265,10,17,10,17,0,0,6,10,15,26,41,3,4,10,13,72,26
3562,Michael Brown,SO,2014-15,G-F,Navy,Patriot,21,152,10,26,10,23,0,3,6,10,12,8,20,2,5,1,8,25,26
3563,Jamie Chapman,JR,2014-15,G,Southern Mississippi,CUSA,23,274,9,23,7,17,2,6,6,15,16,18,34,21,8,3,13,43,26
3564,Dre' Clayton,FR,2014-15,F,South Florida,AAC,28,215,9,37,6,19,3,18,5,11,12,31,43,7,4,5,12,21,26
3565,Barnett Harris,SO,2014-15,F,Delaware,CAA,29,303,5,26,5,26,0,0,16,28,32,43,75,9,6,12,9,55,26
3566,Juwan Henderson,FR,2014-15,G,Alcorn State,SWAC,11,212,9,46,6,28,3,18,5,6,5,17,22,30,14,1,16,16,26
3567,Bryce Jackson,FR,2014-15,F,New Orleans,Southland,23,159,8,21,6,12,2,9,8,12,5,8,13,3,1,2,13,25,26
3568,Houston Kessler,SO,2014-15,F,Georgia,SEC,29,181,9,26,6,17,3,9,5,10,10,17,27,0,2,4,9,22,26
3569,Matt Korcheck,SR,2014-15,F,Arizona,Pac-12,21,77,10,14,10,14,0,0,6,6,7,10,17,3,1,7,1,9,26
3570,Mike LaTulip,JR,2014-15,G,Illinois,Big Ten,16,45,6,13,2,4,4,9,10,10,0,9,9,0,1,0,1,3,26
3571,Dederick Lee,FR,2014-15,G,Oral Roberts,Summit,20,158,7,28,0,2,7,26,5,6,8,8,16,13,3,1,7,15,26
3572,Erik Nissen,SO,2014-15,F,Maine,AEC,20,116,12,33,12,33,0,0,2,5,5,23,28,3,3,3,10,22,26
3573,Trayvon Reed,FR,2014-15,C,Auburn,SEC,23,205,9,22,9,22,0,0,8,22,17,29,46,3,2,16,12,36,26
3574,Dakota Slaughter,SR,2014-15,F,Alabama,SEC,15,93,9,17,3,3,6,14,2,2,3,3,6,3,2,1,2,8,26
3575,Cheick Thiero,JR,2014-15,F,California-Riverside,Big West,16,96,12,17,12,17,0,0,2,2,4,20,24,0,2,0,6,19,26
3576,Grant Vermeer,SO,2014-15,G,Navy,Patriot,12,128,12,21,12,15,0,6,2,3,6,8,14,10,6,0,12,7,26
3577,Dantley Walker,FR,2014-15,G,Nevada-Las Vegas,MWC,11,64,9,24,1,4,8,20,0,0,0,5,5,1,0,0,0,7,26
3578,Kwesi Abakah,SO,2014-15,F,Northeastern,CAA,25,112,9,19,9,19,0,0,7,13,6,15,21,0,0,1,3,20,25
3579,Ryan Bass,SR,2014-15,G,Dayton,A-10,8,76,9,29,8,22,1,7,6,8,1,8,9,6,1,0,3,9,25
3580,Kevin Chuisseu,JR,2014-15,F,Furman,Southern,15,151,9,23,9,23,0,0,7,23,10,34,44,3,2,1,11,25,25
3581,C.J. Davis,FR,2014-15,G,Tennessee-Martin,OVC,15,37,9,22,3,6,6,16,1,3,1,1,2,1,3,0,0,1,25
3582,Kennedy Edwards,SO,2014-15,F,Army,Patriot,4,55,8,17,6,11,2,6,7,11,5,7,12,2,4,3,4,6,25
3583,Corey Heyward,SO,2014-15,G,Georgia Tech,ACC,19,225,8,26,6,15,2,11,7,13,3,11,14,10,10,1,8,29,25
3584,Reginald Kissoonlal,FR,2014-15,G-F,Northwestern State,Southland,8,74,8,34,4,10,4,24,5,7,4,7,11,2,2,9,4,17,25
3585,Jeremiah Kreisberg,SR,2014-15,C,Northwestern,Big Ten,24,155,8,18,8,18,0,0,9,14,14,14,28,4,1,2,13,26,25
3586,Avery Lomax,JR,2014-15,G,Prairie View,SWAC,18,63,8,18,6,9,2,9,7,12,3,4,7,7,5,0,8,18,25
3587,Myles Mann,SO,2014-15,F,Fairleigh Dickinson,NEC,24,127,11,20,11,20,0,0,3,11,13,19,32,2,3,7,6,29,25
3588,Jalen McCallum,SO,2014-15,G,IUPUI,Summit,11,61,9,16,4,6,5,10,2,3,0,1,1,8,7,0,6,15,25
3589,Chidozie Omile,JR,2014-15,G-F,Alabama State,SWAC,16,110,10,33,6,12,4,21,1,2,1,4,5,6,2,0,8,4,25
3590,Josh Perkins,FR,2014-15,G,Gonzaga,WCC,5,101,9,18,5,8,4,10,3,4,0,5,5,17,4,1,10,7,25
3591,Van Rolle,SO,2014-15,G,Coppin State,MEAC,11,64,8,22,2,9,6,13,3,9,3,1,4,6,0,0,9,4,25
3592,Aaron Scales,SO,2014-15,C,Cleveland State,Horizon,23,129,11,25,11,25,0,0,3,8,16,12,28,2,5,2,12,29,25
3593,Blake Simpson,FR,2014-15,F,Coppin State,MEAC,25,225,7,29,7,29,0,0,11,21,24,19,43,4,1,8,15,43,25
3594,Joshua Spiers,FR,2014-15,F,Loyola Marymount,WCC,15,109,8,22,2,6,6,16,3,6,5,4,9,4,0,1,7,14,25
3595,Craig Victor,FR,2014-15,F,Arizona,Pac-12,8,57,8,13,8,13,0,0,9,17,6,3,9,0,3,2,1,4,25
3596,Derek Willis,SO,2014-15,F,Kentucky,SEC,19,75,7,18,2,3,5,15,6,6,5,9,14,5,2,3,8,5,25
3597,Patrick Wrencher,SO,2014-15,F,Saint Francis (PA),NEC,22,148,12,22,12,22,0,0,1,5,16,18,34,3,1,5,10,24,25
3598,Jalen Adams,FR,2014-15,G,St. Bonaventure,A-10,14,62,8,23,5,12,3,11,5,7,0,1,1,3,3,0,2,6,24
3599,Wesley Afolayan,JR,2014-15,F,Prairie View,SWAC,20,121,9,28,9,28,0,0,6,17,11,16,27,0,1,3,10,30,24
3600,Henry Bolton,FR,2014-15,G,Utah State,MWC,29,268,9,25,8,20,1,5,5,9,4,19,23,22,8,3,21,16,24
3601,Michael Chandler,JR,2014-15,F,Southern Illinois-Edwardsville,OVC,27,168,12,20,12,19,0,1,0,5,17,15,32,2,2,27,7,23,24
3602,Jon'te Dotson,SO,2014-15,G,Northern Colorado,Big Sky,17,145,8,20,3,8,5,12,3,5,5,4,9,8,6,0,2,10,24
3603,Bik Gill,JR,2014-15,F-C,Ball State,MAC,15,118,5,24,3,11,2,13,12,15,7,18,25,3,2,3,14,9,24
3604,John Ross Glover,SO,2014-15,G-F,Lehigh,Patriot,7,34,8,16,8,15,0,1,8,12,3,5,8,2,0,1,2,7,24
3605,Eliel Gonzalez,FR,2014-15,G,Hofstra,CAA,19,78,9,15,9,14,0,1,6,14,1,4,5,5,4,1,13,14,24
3606,Justin Jamison,JR,2014-15,F,Texas Tech,Big 12,9,64,8,19,6,15,2,4,6,9,9,9,18,2,1,1,4,13,24
3607,Christian Jones,SO,2014-15,F,St. John's (NY),Big East,20,124,10,19,10,18,0,1,4,6,8,16,24,0,1,1,4,11,24
3608,David Levitch,SO,2014-15,G,Louisville,ACC,21,101,4,15,0,5,4,10,12,17,4,2,6,6,4,0,5,13,24
3609,Rob Marberry,FR,2014-15,F,Western Kentucky,CUSA,12,75,9,14,9,14,0,0,6,12,4,9,13,3,2,1,2,8,24
3610,Wadly Mompremier,SO,2014-15,F,Ohio,MAC,17,141,9,19,8,16,1,3,5,16,6,12,18,3,2,7,8,17,24
3611,Jeffon Powell,SO,2014-15,G-F,Bethune-Cookman,MEAC,22,256,7,26,7,21,0,5,10,14,11,26,37,3,2,1,15,38,24
3612,Brandon Price,SO,2014-15,G,Western Kentucky,CUSA,22,109,6,20,3,11,3,9,9,16,3,3,6,16,3,0,9,9,24
3613,Julian Richardson,FR,2014-15,G,Niagara,MAAC,11,88,7,22,4,9,3,13,7,8,1,4,5,6,2,0,5,5,24
3614,Christian Sanders,JR,2014-15,G,Stanford,Pac-12,35,272,9,30,5,17,4,13,2,7,5,12,17,24,11,0,15,29,24
3615,Tony Armstrong,SO,2014-15,F,Alabama State,SWAC,11,69,10,19,10,19,0,0,3,8,3,4,7,2,1,1,5,6,23
3616,Isaac Belton,SO,2014-15,G,Longwood,Big South,16,48,9,24,6,11,3,13,2,4,3,7,10,2,3,0,3,5,23
3617,Kenny Carpenter,FR,2014-15,G,Cleveland State,Horizon,22,150,8,29,6,18,2,11,5,8,12,15,27,12,2,0,12,19,23
3618,Matthew Cotton,SO,2014-15,G,Alabama A&amp;M,SWAC,23,161,7,29,3,14,4,15,5,13,4,6,10,11,6,0,14,10,23
3619,Anthony Durham,FR,2014-15,G,Rider,MAAC,23,125,10,31,10,24,0,7,3,5,2,5,7,5,5,0,5,7,23
3620,Anthony Fields,JR,2014-15,G,Bradley,MVC,18,119,8,24,7,17,1,7,6,10,0,7,7,4,6,0,6,7,23
3621,Alex Foster,SO,2014-15,F,Texas Tech,Big 12,23,139,10,19,10,19,0,0,3,14,4,14,18,3,0,6,14,21,23
3622,Nahshon George,JR,2014-15,F,Idaho,Big Sky,14,139,10,24,10,23,0,1,3,4,15,25,40,2,3,1,15,23,23
3623,Malcolm Gilbert,SR,2014-15,C,Fairfield,MAAC,25,258,8,30,8,30,0,0,7,11,15,32,47,8,1,33,12,45,23
3624,Skye Johnson,FR,2014-15,F,Delaware,CAA,19,134,8,19,8,19,0,0,7,13,10,17,27,7,4,5,9,14,23
3625,Rakim Lubin,FR,2014-15,F,Connecticut,AAC,24,155,8,15,8,15,0,0,7,15,13,15,28,2,0,4,8,27,23
3626,Jordan Martin,JR,2014-15,G,Eastern Michigan,MAC,13,74,7,14,6,11,1,3,8,16,8,16,24,1,4,0,4,9,23
3627,Dee Oldham,JR,2014-15,G,Tennessee-Martin,OVC,7,117,6,17,3,7,3,10,8,14,3,20,23,11,5,1,5,4,23
3628,Thomas Pierre-Louis,JR,2014-15,F,Southern,SWAC,10,74,10,18,10,18,0,0,3,12,8,8,16,1,2,4,7,15,23
3629,Matt Poplawski,SO,2014-15,G,Pennsylvania,Ivy,17,99,7,24,3,6,4,18,5,9,0,4,4,5,2,0,6,8,23
3630,Quinn Price,FR,2014-15,F,Montana State,Big Sky,25,190,10,26,10,26,0,0,3,6,15,30,45,3,5,14,11,36,23
3631,Jordan Robertson,FR,2014-15,G,Colgate,Patriot,14,123,8,25,3,10,5,15,2,3,4,8,12,3,2,3,7,8,23
3632,Jamie Schneck,SR,2014-15,F-C,Hartford,AEC,29,203,8,18,8,18,0,0,7,11,6,13,19,2,4,13,8,33,23
3633,Dwight Smith,SR,2014-15,G,Northern Colorado,Big Sky,8,161,8,22,6,13,2,9,5,10,1,14,15,12,6,4,11,23,23
3634,Tafari Whittingham,JR,2014-15,F,South Alabama,Sun Belt,5,61,7,16,7,15,0,1,9,14,5,10,15,0,1,4,4,7,23
3635,Tiremone Williams,JR,2014-15,G,Louisiana-Lafayette,Sun Belt,27,200,7,22,5,13,2,9,7,13,1,17,18,17,10,0,16,23,23
3636,Ethan Wilmoth,SO,2014-15,G,North Carolina-Asheville,Big South,10,95,8,19,4,5,4,14,3,6,1,10,11,9,2,1,3,7,23
3637,Jackson Aldridge,SR,2014-15,G,Butler,Big East,19,95,8,20,6,10,2,10,4,9,0,2,2,2,2,0,2,8,22
3638,Carlton Allen,SO,2014-15,C,Manhattan,MAAC,21,146,8,12,8,12,0,0,6,9,7,15,22,1,1,2,5,37,22
3639,Charles Bargman,JR,2014-15,F,Mississippi Valley State,SWAC,19,192,6,32,0,15,6,17,4,6,7,13,20,5,12,2,9,20,22
3640,Colton Bishop,FR,2014-15,G,Loyola (MD),Patriot,28,196,7,25,5,16,2,9,6,11,4,12,16,5,4,1,9,19,22
3641,Theodore Boyomo,SR,2014-15,C-F,Howard,MEAC,19,104,11,14,11,14,0,0,0,3,8,20,28,1,3,0,8,21,22
3642,Alain Chigha,SO,2014-15,F,Quinnipiac,MAAC,16,158,5,15,3,10,2,5,10,15,9,19,28,2,1,0,6,34,22
3643,Montray Clemons,JR,2014-15,F,San Francisco,WCC,15,83,7,19,7,18,0,1,8,14,8,14,22,3,3,2,5,18,22
3644,J.J. Davenport,SR,2014-15,C,Louisiana-Lafayette,Sun Belt,17,86,8,23,8,20,0,3,6,9,4,12,16,2,0,1,7,21,22
3645,Mac Hoffman,SO,2014-15,F,Army,Patriot,18,149,8,22,6,13,2,9,4,5,12,12,24,5,4,3,2,34,22
3646,Zachary Jackson,FR,2014-15,G,Alabama A&amp;M,SWAC,5,47,8,19,5,9,3,10,3,4,2,4,6,3,0,2,4,6,22
3647,Vieux Kande,SO,2014-15,C,Louisiana-Lafayette,Sun Belt,20,63,9,13,9,13,0,0,4,7,5,8,13,0,0,1,7,14,22
3648,Austin Karazsia,FR,2014-15,F,South Alabama,Sun Belt,21,143,8,21,4,11,4,10,2,6,5,16,21,2,3,1,6,16,22
3649,Austin Karrer,FR,2014-15,G,Texas-San Antonio,CUSA,21,147,8,20,5,8,3,12,3,7,5,10,15,5,5,1,5,18,22
3650,Jeff Laidig,JR,2014-15,G,Belmont,OVC,33,229,5,17,0,5,5,12,7,9,12,30,42,6,7,1,8,23,22
3651,Ben Lammers,FR,2014-15,C,Georgia Tech,ACC,19,113,9,21,9,21,0,0,4,9,9,19,28,1,3,4,3,7,22
3652,Roderick Lawrence,JR,2014-15,G,Mississippi,SEC,13,105,8,26,3,12,5,14,1,3,4,13,17,10,4,1,6,9,22
3653,Marcus Love,FR,2014-15,G,Jackson State,SWAC,14,99,9,27,8,16,1,11,3,5,5,4,9,7,3,0,4,13,22
3654,Austin Luke,FR,2014-15,G,Belmont,OVC,30,125,4,15,1,7,3,8,11,15,5,17,22,21,2,1,20,8,22
3655,Ivan Lukic,SO,2014-15,F,James Madison,CAA,15,139,6,16,5,14,1,2,9,14,6,13,19,2,5,3,10,24,22
3656,Darcy Malone,SO,2014-15,C,Louisiana State,SEC,25,216,8,21,8,16,0,5,6,12,13,22,35,11,4,12,11,46,22
3657,Rod Mills,FR,2014-15,F,Miami (OH),MAC,15,79,8,26,4,14,4,12,2,2,3,6,9,0,2,1,7,12,22
3658,Brandon Murphy,FR,2014-15,F-C,Indiana State,MVC,22,127,5,24,5,24,0,0,12,19,11,23,34,0,2,9,6,23,22
3659,Phillip Reed,SO,2014-15,C,Hampton,MEAC,22,209,8,23,8,23,0,0,6,13,20,28,48,4,1,9,10,48,22
3660,Nate Rucker,SR,2014-15,F,Kennesaw State,A-Sun,6,59,9,25,9,25,0,0,4,5,3,12,15,0,0,1,7,11,22
3661,Andre Slavik,SO,2014-15,F-C,Idaho State,Big Sky,23,196,10,14,10,14,0,0,2,7,9,10,19,1,2,3,10,30,22
3662,Derek Sloan,FR,2014-15,F,Cleveland State,Horizon,21,123,9,17,9,17,0,0,4,8,2,14,16,5,2,3,3,23,22
3663,Artem Tavakalyan,FR,2014-15,F,Delaware State,MEAC,13,81,8,22,6,13,2,9,4,12,2,10,12,1,2,2,5,11,22
3664,Theo Turner,FR,2014-15,C,Seattle,WAC,18,150,9,23,9,22,0,1,4,14,10,26,36,3,4,0,15,17,22
3665,Dawson Verhines,SR,2014-15,G,Southern Illinois,MVC,31,223,6,18,2,10,4,8,6,9,6,14,20,7,8,1,13,13,22
3666,Andre Walker,FR,2014-15,F-C,Hofstra,CAA,17,162,9,20,9,20,0,0,4,8,8,43,51,4,2,21,6,37,22
3667,BillyDee Williams,JR,2014-15,F,West Virginia,Big 12,18,131,9,40,5,24,4,16,0,1,10,17,27,7,4,1,4,21,22
3668,Chris Wray,FR,2014-15,F,Mount St. Mary's,NEC,18,115,10,17,10,17,0,0,2,6,11,12,23,0,8,5,3,14,22
3669,Leon Bahner,FR,2014-15,C,San Jose State,MWC,9,168,5,14,5,14,0,0,11,19,14,23,37,0,1,10,10,17,21
3670,Ted Bancroft,SR,2014-15,G,Providence,Big East,21,90,6,16,1,2,5,14,4,7,4,11,15,3,3,2,3,10,21
3671,Alex Bran,JR,2014-15,G,Chattanooga,Southern,13,76,7,23,4,6,3,17,4,7,1,8,9,1,0,2,3,7,21
3672,Tate de Laveaga,FR,2014-15,G,Northern Arizona,Big Sky,26,138,6,27,5,13,1,14,8,10,5,9,14,4,2,0,9,23,21
3673,Terrence Durham,JR,2014-15,G,Tennessee-Martin,OVC,29,213,6,25,5,16,1,9,8,13,3,22,25,21,8,1,15,25,21
3674,Frankie Ferrari,FR,2014-15,G,San Francisco,WCC,16,143,8,28,7,14,1,14,4,5,0,19,19,11,2,0,11,21,21
3675,Dayon Goodman,FR,2014-15,F,Utah Valley,WAC,16,102,8,21,8,21,0,0,5,11,11,17,28,5,3,2,6,6,21
3676,Scott Mammel,SO,2014-15,G,Army,Patriot,16,93,7,24,4,13,3,11,4,4,1,6,7,9,3,0,8,17,21
3677,Austin Mills,JR,2014-15,G,Baylor,Big 12,17,99,5,14,3,6,2,8,9,10,0,4,4,14,3,0,7,11,21
3678,Tanner Sanders,FR,2014-15,G,Oregon State,Pac-12,21,123,8,22,3,7,5,15,0,0,3,15,18,7,5,0,8,16,21
3679,Jackson Simmons,SR,2014-15,F,North Carolina,ACC,28,102,9,13,9,13,0,0,3,4,7,5,12,1,2,0,2,17,21
3680,Randall Smith,FR,2014-15,G,Jacksonville State,OVC,15,86,5,17,3,10,2,7,9,10,1,6,7,6,2,1,11,14,21
3681,Justin Strings,FR,2014-15,F,Sacramento State,Big Sky,25,106,8,13,8,13,0,0,5,13,4,14,18,7,1,2,3,17,21
3682,D.J. Ursery,FR,2014-15,G,Pacific,WCC,12,75,9,23,7,16,2,7,1,2,2,10,12,3,2,0,7,14,21
3683,Dwain Whitfield,FR,2014-15,G,Mississippi Valley State,SWAC,27,254,8,27,8,26,0,1,5,11,19,16,35,10,3,0,10,39,21
3684,Jonathan Barnes,FR,2014-15,C,Wyoming,MWC,14,64,7,14,7,14,0,0,6,10,4,11,15,1,1,4,5,6,20
3685,Charlendez Brooks,FR,2014-15,F,Western Carolina,Southern,18,150,9,18,9,18,0,0,2,6,6,11,17,5,1,7,7,26,20
3686,Conrad Chambers,FR,2014-15,G,Morgan State,MEAC,14,65,6,22,3,13,3,9,5,8,3,4,7,9,0,0,10,10,20
3687,Maurice Dunlap,FR,2014-15,G,Mississippi State,SEC,7,72,6,22,3,8,3,14,5,6,1,3,4,1,2,0,3,11,20
3688,Williams Gabriel,SO,2014-15,F,New Hampshire,AEC,17,92,9,20,9,20,0,0,2,2,9,18,27,1,3,5,8,19,20
3689,Tom Lacey,FR,2014-15,F,Navy,Patriot,15,117,7,17,7,17,0,0,6,11,9,15,24,4,5,3,9,19,20
3690,Maxwell Lenox,SR,2014-15,G,Army,Patriot,7,81,9,22,8,17,1,5,1,4,5,10,15,15,5,0,10,12,20
3691,Stan Mays,SO,2014-15,G,Texas Tech,Big 12,9,35,5,11,1,1,4,10,6,8,1,2,3,1,0,0,6,2,20
3692,Garvey Melmed,FR,2014-15,G,Maine,AEC,29,330,7,35,2,5,5,30,1,6,7,21,28,10,4,0,9,23,20
3693,John Odo,SR,2014-15,F,Louisiana State,SEC,16,114,8,14,8,14,0,0,4,6,8,10,18,2,0,6,4,14,20
3694,Michael Phillip,JR,2014-15,C,Florida International,CUSA,33,194,7,13,7,13,0,0,6,15,13,19,32,6,0,12,3,50,20
3695,Stevie Repichowski,SO,2014-15,G,Tulsa,AAC,22,98,5,27,0,3,5,24,5,6,0,8,8,0,1,0,5,7,20
3696,Lance Richard,FR,2014-15,G,Louisiana-Monroe,Sun Belt,19,59,7,26,1,2,6,24,0,0,1,5,6,1,2,1,2,5,20
3697,Patrick Rooks,FR,2014-15,G,Clemson,ACC,13,52,6,22,0,3,6,19,2,5,0,3,3,6,3,0,0,6,20
3698,Cassidy Ryan,FR,2014-15,F,Canisius,MAAC,16,95,9,29,8,25,1,4,1,1,3,7,10,6,0,1,9,18,20
3699,Jayson Snearl,FR,2014-15,F,Florida A&amp;M,MEAC,25,196,9,24,9,24,0,0,2,2,10,23,33,1,3,1,8,33,20
3700,Nick Babb,FR,2014-15,G,Arkansas,SEC,26,125,7,22,4,13,3,9,2,2,6,14,20,14,5,3,5,7,19
3701,Erik Copes,SR,2014-15,F-C,George Mason,A-10,4,66,5,10,5,10,0,0,9,11,10,7,17,2,0,4,1,13,19
3702,Elijah Foster,FR,2014-15,F,Nevada,MWC,21,133,8,17,8,17,0,0,3,3,10,25,35,2,2,0,3,20,19
3703,Larry Haley,JR,2014-15,G,Delaware State,MEAC,5,32,6,17,3,5,3,12,4,4,1,3,4,1,0,0,1,4,19
3704,Christian Harrison,FR,2014-15,G-F,Troy,Sun Belt,22,116,6,14,5,11,1,3,6,10,10,13,23,2,6,3,4,14,19
3705,Philipp Hartwich,FR,2014-15,C,Portland,WCC,24,112,7,14,7,14,0,0,5,15,8,15,23,1,1,8,14,25,19
3706,Jaxon Holden,FR,2014-15,G,Stephen F. Austin,Southland,17,67,4,14,0,5,4,9,7,7,0,3,3,1,1,0,4,12,19
3707,Otas Iyekekpolor,FR,2014-15,F,Central Arkansas,Southland,23,149,5,16,3,11,2,5,7,12,5,11,16,3,1,8,11,28,19
3708,Link Kabadyundi,FR,2014-15,C,Texas Christian,Big 12,15,69,8,13,8,13,0,0,3,12,11,9,20,2,2,10,5,12,19
3709,T.J. Maston,FR,2014-15,F,Baylor,Big 12,11,36,8,15,8,15,0,0,3,4,5,5,10,1,2,1,3,5,19
3710,Serigne Mboup,SO,2014-15,F-C,Austin Peay,OVC,21,104,4,17,4,17,0,0,11,16,11,7,18,5,2,3,11,23,19
3711,Dalique Mingo,FR,2014-15,G,Howard,MEAC,13,54,7,20,2,7,5,13,0,0,3,3,6,2,1,0,5,7,19
3712,Shaq Preston,FR,2014-15,G,Chattanooga,Southern,8,64,6,26,5,22,1,4,6,12,4,7,11,5,4,1,11,10,19
3713,Shane Randall,FR,2014-15,F,Maryland-Eastern Shore,MEAC,22,127,5,22,5,22,0,0,9,12,12,13,25,3,0,2,8,18,19
3714,Ilias Theodorou,FR,2014-15,F,Pacific,WCC,11,64,7,18,4,9,3,9,2,5,4,5,9,1,1,0,3,9,19
3715,D'Erryl Williams,SO,2014-15,G,San Diego State,MWC,17,129,8,14,6,11,2,3,1,2,3,9,12,7,10,0,8,12,19
3716,Donovan Williams,SR,2014-15,G,Louisiana-Lafayette,Sun Belt,6,42,7,18,3,7,4,11,1,4,3,2,5,2,5,1,2,4,19
3717,David Wishon,JR,2014-15,C,College of Charleston,CAA,10,83,8,13,8,13,0,0,3,10,4,6,10,0,1,6,7,18,19
3718,Omar Beauperthuy,JR,2014-15,F,Alcorn State,SWAC,22,182,7,21,7,19,0,2,4,6,10,18,28,5,0,2,11,26,18
3719,Leo Edwards,FR,2014-15,F,Louisiana Tech,CUSA,20,100,7,12,7,12,0,0,4,5,9,17,26,1,0,4,9,18,18
3720,Aaron Epps,FR,2014-15,F,Louisiana State,SEC,14,86,8,24,6,16,2,8,0,0,9,11,20,4,4,5,6,9,18
3721,Niko Filipovich,FR,2014-15,G,Hawaii,Big West,20,91,5,17,3,5,2,12,6,6,2,5,7,5,3,0,7,14,18
3722,Herbert Graham,JR,2014-15,G,IPFW,Summit,6,63,7,17,4,6,3,11,1,2,1,14,15,0,4,2,2,10,18
3723,Avery Johnson,FR,2014-15,G,Texas A&amp;M,SEC,13,56,7,20,6,14,1,6,3,5,0,3,3,1,0,0,2,8,18
3724,Clark Lammert,SR,2014-15,F,Texas Tech,Big 12,29,212,6,16,5,13,1,3,5,14,20,22,42,15,4,2,8,16,18
3725,Semi Ojeleye,SO,2014-15,F,Duke,ACC,6,63,5,18,1,2,4,16,4,7,3,11,14,1,3,0,0,11,18
3726,Matt Panaggio,FR,2014-15,G,Mercer,Southern,29,149,6,18,4,13,2,5,4,7,7,16,23,9,4,0,13,13,18
3727,Jared Ravenscraft,JR,2014-15,G,Morehead State,OVC,7,27,6,9,1,1,5,8,1,2,1,2,3,2,0,0,1,5,18
3728,Jordan Reed,JR,2014-15,G,Binghamton,AEC,5,53,6,21,6,19,0,2,6,7,6,11,17,2,5,3,8,6,18
3729,Jake Showalter,FR,2014-15,G,North Dakota State,Summit,13,38,6,12,2,2,4,10,2,2,1,5,6,0,0,0,2,2,18
3730,Rondale Watson,FR,2014-15,G,Wake Forest,ACC,12,77,5,20,1,8,4,12,4,7,1,8,9,4,3,0,3,9,18
3731,Jonathan Wiley,FR,2014-15,G,Texas State,Sun Belt,9,45,6,10,6,10,0,0,6,10,7,6,13,0,0,1,0,5,18
3732,Jai Williams,FR,2014-15,F,Saint Joseph's,A-10,14,98,8,13,8,13,0,0,2,4,6,10,16,1,4,4,5,22,18
3733,Tommy Williams,JR,2014-15,F,East Tennessee State,Southern,14,93,6,23,6,23,0,0,6,13,14,16,30,0,2,3,7,17,18
3734,Caleb Woods,SR,2014-15,G-F,Southeast Missouri State,OVC,5,21,6,14,2,5,4,9,2,4,2,1,3,3,1,0,0,1,18
3735,Aitor Zubizarreta,SO,2014-15,G,Portland,WCC,25,148,7,20,6,10,1,10,3,5,4,10,14,17,10,0,14,26,18
3736,Aleks Abrams,FR,2014-15,F,Cal Poly,Big West,26,196,4,32,4,32,0,0,9,12,28,27,55,2,1,8,4,36,17
3737,Deji Adekunle,JR,2014-15,F,Northwestern State,Southland,17,120,7,16,7,16,0,0,3,9,8,21,29,1,1,2,11,21,17
3738,Braeden Anderson,SO,2014-15,F,Fresno State,MWC,17,181,3,17,3,17,0,0,11,23,14,16,30,3,4,4,8,28,17
3739,Larry Austin,FR,2014-15,G,Xavier,Big East,26,111,7,14,7,14,0,0,3,4,1,10,11,6,5,0,11,15,17
3740,Wanaah Bail,SO,2014-15,F,UCLA,Pac-12,11,99,7,18,7,18,0,0,3,9,13,16,29,1,1,2,4,8,17
3741,John Baker,SO,2014-15,F,Incarnate Word,Southland,14,105,7,18,7,18,0,0,3,6,5,16,21,0,1,0,1,10,17
3742,DeAndre Barber,FR,2014-15,G,High Point,Big South,19,172,6,14,4,8,2,6,3,6,0,10,10,15,4,0,7,20,17
3743,James Bento,SO,2014-15,F,Mercer,Southern,13,104,7,15,7,14,0,1,3,8,4,20,24,2,2,1,2,14,17
3744,Tyree Bynum,SO,2014-15,G,Texas Southern,SWAC,11,96,7,24,4,12,3,12,0,0,0,8,8,2,1,0,5,3,17
3745,Tyler Clement,FR,2014-15,G,Creighton,Big East,26,145,5,23,1,7,4,16,3,7,1,12,13,13,2,0,11,15,17
3746,Prince Cooper,SO,2014-15,G,Louisiana-Monroe,Sun Belt,19,119,8,18,8,18,0,0,1,9,7,13,20,9,3,1,9,6,17
3747,Trace Cureton,JR,2014-15,F,Utah State,MWC,11,73,5,18,3,13,2,5,5,8,1,6,7,2,3,0,4,3,17
3748,William Gates,SO,2014-15,G,Furman,Southern,7,91,7,22,4,9,3,13,0,1,0,4,4,6,0,0,2,6,17
3749,Tre Green,SO,2014-15,G,Albany (NY),AEC,12,54,5,16,3,11,2,5,5,7,0,6,6,2,3,0,6,4,17
3750,Corey Hensley,SR,2014-15,C,Gardner-Webb,Big South,19,121,8,16,8,16,0,0,1,1,12,18,30,2,1,4,6,20,17
3751,Kyle McLeroy,JR,2014-15,G,Sam Houston State,Southland,14,40,4,11,1,2,3,9,6,6,0,2,2,4,1,0,4,3,17
3752,Aron Phillips-Nwankwo,SR,2014-15,F,Pittsburgh,ACC,14,81,7,13,7,12,0,1,3,3,4,12,16,1,3,0,2,11,17
3753,Nate Pollard,FR,2014-15,C,Rice,CUSA,25,142,6,14,6,14,0,0,5,9,9,19,28,2,2,5,16,36,17
3754,Maurice Taylor,SR,2014-15,G,Bethune-Cookman,MEAC,13,114,7,26,6,24,1,2,2,4,5,16,21,1,1,1,7,8,17
3755,Jesse Tesmer,JR,2014-15,F,Chicago State,WAC,19,161,6,22,6,22,0,0,5,6,5,9,14,0,3,1,7,20,17
3756,Shane Benton,JR,2014-15,G,North Dakota,Big Sky,11,73,5,13,3,5,2,8,4,5,1,7,8,2,1,0,1,16,16
3757,Seth Berger,SO,2014-15,F,Massachusetts,A-10,8,109,6,16,4,10,2,6,2,2,7,9,16,6,11,2,5,17,16
3758,Devon Carter,JR,2014-15,G,Lehigh,Patriot,17,73,5,16,3,9,2,7,4,4,2,9,11,5,3,0,1,6,16
3759,Samuel Dingba,FR,2014-15,F,Quinnipiac,MAAC,18,144,5,13,5,13,0,0,6,10,10,21,31,4,3,7,8,27,16
3760,Ben Freeland,JR,2014-15,F,Lafayette,Patriot,20,66,6,17,6,17,0,0,4,10,5,7,12,2,1,0,4,16,16
3761,Christian Gore,JR,2014-15,G,Texas Christian,Big 12,17,75,5,12,1,2,4,10,2,3,0,8,8,1,2,1,7,8,16
3762,Marcus Graves,FR,2014-15,G,Sacramento State,Big Sky,13,69,6,22,2,9,4,13,0,1,0,4,4,4,3,0,5,11,16
3763,Bradley Hayes,JR,2014-15,C,Georgetown,Big East,17,69,7,11,7,11,0,0,2,5,12,12,24,2,2,2,2,11,16
3764,Dylan Johns,SO,2014-15,C,Texas A&amp;M,SEC,13,70,7,12,7,12,0,0,2,2,5,6,11,3,1,3,5,11,16
3765,Larry Johnson,JR,2014-15,F,Youngstown State,Horizon,22,92,5,15,5,15,0,0,6,12,6,16,22,2,4,3,3,27,16
3766,Evan Maschmeyer,SR,2014-15,G,Saint Joseph's,A-10,22,121,7,25,6,14,1,11,1,2,1,5,6,7,3,1,9,9,16
3767,Garrett Mayleben,FR,2014-15,F,Bowling Green State,MAC,22,190,7,26,5,12,2,14,0,0,8,15,23,0,0,2,6,17,16
3768,Brandon McDonnell,JR,2014-15,F,Dartmouth,Ivy,7,48,7,18,6,13,1,5,1,2,8,9,17,1,2,3,4,13,16
3769,Robert Mischler,JR,2014-15,G,Cornell,Ivy,11,45,5,7,2,2,3,5,3,6,0,2,2,1,1,0,0,3,16
3770,Lucas O'Brien,SO,2014-15,C,Texas-San Antonio,CUSA,16,65,6,15,5,11,1,4,3,5,3,8,11,1,1,0,9,15,16
3771,Ugo Okam,GR,2014-15,C,Bethune-Cookman,MEAC,16,114,6,13,6,13,0,0,4,8,7,8,15,3,1,4,10,18,16
3772,Landon Russell,FR,2014-15,G,Yale,Ivy,6,35,6,13,4,6,2,7,2,2,1,3,4,2,0,0,1,1,16
3773,Chad Sherwood,FR,2014-15,G,Idaho,Big Sky,6,49,5,14,0,3,5,11,1,2,0,4,4,2,1,1,2,9,16
3774,Stephen Spurlock,FR,2014-15,G-F,Maryland-Eastern Shore,MEAC,18,83,6,12,6,12,0,0,4,6,7,10,17,2,1,1,1,7,16
3775,Henry Uwadiae,SO,2014-15,F-C,Green Bay,Horizon,17,89,7,11,7,11,0,0,2,7,4,9,13,2,1,15,9,26,16
3776,Devin Waddell,JR,2014-15,G-F,Auburn,SEC,27,204,6,18,5,13,1,5,3,6,10,22,32,4,0,4,1,32,16
3777,Herve Aholode,JR,2014-15,F,Gardner-Webb,Big South,11,56,5,16,5,16,0,0,5,7,8,7,15,1,3,2,4,6,15
3778,Brandon Allen,SO,2014-15,F,Florida State,ACC,24,116,5,16,2,7,3,9,2,2,4,10,14,5,4,2,7,21,15
3779,Chinedu Amajoyi,SR,2014-15,G,Louisiana-Monroe,Sun Belt,22,134,6,22,5,12,1,10,2,2,2,14,16,13,1,0,7,12,15
3780,Eric Anderson,FR,2014-15,G-F,Yale,Ivy,7,43,5,9,4,6,1,3,4,10,1,6,7,1,2,1,0,5,15
3781,Conroy Baltimore,SR,2014-15,F,Lehigh,Patriot,7,32,7,11,7,11,0,0,1,2,3,7,10,0,2,2,1,5,15
3782,Corey Barnes,FR,2014-15,G,Alcorn State,SWAC,7,41,5,16,1,3,4,13,1,4,0,2,2,0,1,0,5,8,15
3783,Brandon Bolden,SO,2014-15,F,Kansas State,Big 12,17,71,6,12,6,12,0,0,3,9,5,10,15,1,2,8,7,7,15
3784,Jared Bryant,JR,2014-15,F-C,Northern Kentucky,A-Sun,10,69,7,13,7,13,0,0,1,2,7,12,19,1,0,1,1,16,15
3785,Domas Budrys,FR,2014-15,G,Austin Peay,OVC,14,59,5,16,1,3,4,13,1,5,1,3,4,0,1,0,3,6,15
3786,Joe Burton,FR,2014-15,G-F,Oklahoma State,Big 12,9,32,5,15,4,8,1,7,4,7,4,1,5,0,0,0,2,3,15
3787,John Cain Carney,SR,2014-15,F,Boston College,ACC,26,204,7,16,6,12,1,4,0,3,7,29,36,3,6,2,7,27,15
3788,Whitley Carter,SO,2014-15,G,Savannah State,MEAC,25,128,4,18,1,6,3,12,4,4,3,7,10,9,4,0,8,15,15
3789,Barry Cheaney,JR,2014-15,G,Nevada-Las Vegas,MWC,8,26,6,12,4,6,2,6,1,1,0,1,1,0,1,0,2,2,15
3790,Deion Clark,SO,2014-15,G,Old Dominion,CUSA,20,70,5,15,5,11,0,4,5,7,5,6,11,1,2,0,2,3,15
3791,Grayson Clark,SO,2014-15,G,Georgia Southern,Sun Belt,6,32,5,12,2,5,3,7,2,4,4,7,11,0,0,0,2,3,15
3792,Garrett Collins,FR,2014-15,G,North Carolina-Greensboro,Southern,9,28,5,7,0,1,5,6,0,0,0,1,1,3,1,0,0,2,15
3793,Austin Cox,FR,2014-15,G,Arkansas-Pine Bluff,SWAC,14,62,5,11,5,8,0,3,5,6,4,7,11,1,4,1,5,1,15
3794,Jackson Davis,FR,2014-15,F,Butler,Big East,17,67,6,17,6,17,0,0,3,9,3,20,23,0,2,4,3,12,15
3795,Quincy Drye,SR,2014-15,G,High Point,Big South,5,20,5,9,5,9,0,0,5,6,1,3,4,1,2,0,0,2,15
3796,Nourse Fox,FR,2014-15,G,Navy,Patriot,11,82,5,15,2,7,3,8,2,4,0,5,5,8,3,0,4,9,15
3797,Terron Gilmore,JR,2014-15,F,Murray State,OVC,14,73,3,9,3,9,0,0,9,15,8,12,20,1,4,0,10,21,15
3798,Nick Havener,FR,2014-15,F,Boston University,Patriot,16,130,6,16,6,13,0,3,3,5,12,20,32,3,6,1,10,20,15
3799,Marcus Holt,SR,2014-15,F-C,Colorado State,MWC,15,89,6,12,6,9,0,3,3,9,9,6,15,0,3,1,2,9,15
3800,Logan Hovey,FR,2014-15,F,Florida Gulf Coast,A-Sun,14,92,6,14,6,13,0,1,3,9,8,16,24,3,2,1,3,11,15
3801,Brian Ishola,FR,2014-15,G,North Dakota State,Summit,14,95,3,9,3,9,0,0,9,12,3,7,10,1,0,0,2,12,15
3802,Cory Jacobsen,JR,2014-15,G,South Dakota State,Summit,12,41,5,10,1,1,4,9,1,1,0,3,3,2,0,0,1,6,15
3803,Tommy Matthews,JR,2014-15,G,Eastern Kentucky,OVC,33,171,4,18,3,10,1,8,6,8,3,19,22,10,15,2,9,47,15
3804,Lonnie McElwain,JR,2014-15,F,Grambling,SWAC,18,186,6,19,6,17,0,2,3,4,8,13,21,1,2,5,13,47,15
3805,Liam McManimon,JR,2014-15,G,Mount St. Mary's,NEC,11,24,5,16,1,2,4,14,1,2,1,1,2,1,1,0,1,2,15
3806,Josh Murray,SO,2014-15,C,Jacksonville,A-Sun,16,129,7,21,7,21,0,0,1,1,11,9,20,2,6,7,3,11,15
3807,Jamar Pope,JR,2014-15,G,Alabama State,SWAC,10,57,5,10,3,5,2,5,3,4,1,6,7,2,4,0,2,4,15
3808,David Tillman,SO,2014-15,C,Arkansas-Pine Bluff,SWAC,23,97,6,10,6,10,0,0,3,9,8,6,14,2,0,8,9,19,15
3809,Johnnie Vassar,FR,2014-15,G,Northwestern,Big Ten,18,70,7,19,6,14,1,5,0,3,2,5,7,8,2,0,7,13,15
3810,Jake Verhagen,SO,2014-15,F,Eastern Illinois,OVC,19,81,6,18,3,4,3,14,0,0,3,11,14,4,2,2,1,6,15
3811,Arthur Wade,JR,2014-15,G,Alabama A&amp;M,SWAC,11,84,6,14,4,8,2,6,1,5,3,5,8,2,6,0,2,8,15
3812,Jerron Washington,JR,2014-15,G-F,Arkansas-Little Rock,Sun Belt,22,126,5,23,5,21,0,2,5,10,1,16,17,3,4,1,7,12,15
3813,Will Adams,SO,2014-15,G,Presbyterian,Big South,21,88,4,18,0,4,4,14,2,2,1,6,7,1,3,1,8,12,14
3814,Khalil Batie,SO,2014-15,G,Rutgers,Big Ten,15,48,5,17,1,8,4,9,0,0,2,6,8,2,2,0,2,3,14
3815,Cory Cardwell,SR,2014-15,G,Utah Valley,WAC,14,73,4,16,2,2,2,14,4,4,0,6,6,7,1,0,5,12,14
3816,Sooren Derboghosian,SR,2014-15,C,Drexel,CAA,8,53,6,9,6,9,0,0,2,3,11,3,14,0,0,0,5,5,14
3817,Gilles Dierickx,JR,2014-15,C,Washington,Pac-12,14,139,7,24,7,24,0,0,0,1,11,10,21,4,3,3,8,25,14
3818,Michael Donovan,SR,2014-15,G,Virginia Military Institute,Southern,12,57,4,12,0,1,4,11,2,2,4,7,11,2,0,0,2,8,14
3819,Logan Doyle,FR,2014-15,F,South Dakota State,Summit,8,29,3,6,3,5,0,1,8,9,3,10,13,2,0,2,1,3,14
3820,Ernie Duncan,FR,2014-15,G,Vermont,AEC,4,56,4,13,0,2,4,11,2,2,0,6,6,10,0,0,5,3,14
3821,BJ Edwards,FR,2014-15,G,Jacksonville,A-Sun,27,342,5,40,5,38,0,2,4,10,5,18,23,32,9,4,18,30,14
3822,Matt Farrell,FR,2014-15,G,Notre Dame,ACC,15,62,3,13,2,7,1,6,7,8,0,6,6,7,2,0,3,3,14
3823,Travis Gibson,FR,2014-15,G,Alcorn State,SWAC,24,127,4,30,0,2,4,28,2,3,0,5,5,6,7,0,9,6,14
3824,Jamison Glover,FR,2014-15,G,William &amp; Mary,CAA,5,16,2,6,2,6,0,0,10,13,3,3,6,1,1,0,2,1,14
3825,Mark Hall,SO,2014-15,G,Illinois State,MVC,9,57,6,16,6,11,0,5,2,2,1,4,5,8,0,0,4,4,14
3826,Radin Hughes,FR,2014-15,G,South Carolina State,MEAC,15,83,5,17,5,16,0,1,4,9,4,5,9,7,2,0,11,10,14
3827,Tyler Jenkins,FR,2014-15,G,Lehigh,Patriot,5,23,3,5,1,2,2,3,6,7,0,3,3,5,2,0,2,2,14
3828,Kaleb Mallory,SO,2014-15,G,Ball State,MAC,13,108,5,16,4,11,1,5,3,7,0,4,4,13,5,1,6,7,14
3829,Alexsander Milosavljevic,JR,2014-15,F,Abilene Christian,Southland,21,88,7,20,7,20,0,0,0,0,12,7,19,1,1,0,6,8,14
3830,Hashim Moore,SO,2014-15,F,Princeton,Ivy,4,18,6,9,6,9,0,0,2,3,2,3,5,1,0,0,2,4,14
3831,Travis Rollo,JR,2014-15,F-C,Army,Patriot,24,212,6,12,6,12,0,0,2,8,9,16,25,9,3,5,3,21,14
3832,Hefeng Sun,JR,2014-15,F,Norfolk State,MEAC,18,65,6,11,6,11,0,0,2,2,0,4,4,2,1,2,3,9,14
3833,Chris Tang,FR,2014-15,G,California-Riverside,Big West,10,39,6,11,4,7,2,4,0,2,2,6,8,3,0,0,1,4,14
3834,Mading Thok,SO,2014-15,C,Ball State,MAC,4,23,4,6,4,6,0,0,6,10,5,4,9,1,0,1,1,6,14
3835,Brandon Thompson,FR,2014-15,G,Citadel,Southern,10,36,5,10,1,3,4,7,0,0,0,1,1,2,0,0,1,4,14
3836,J.D. Tisdale,SO,2014-15,G,Bowling Green State,MAC,17,110,3,15,2,7,1,8,7,11,6,16,22,7,1,2,8,9,14
3837,Sai Tummala,JR,2014-15,F,Arizona State,Pac-12,14,59,4,12,2,4,2,8,4,6,2,5,7,4,1,0,4,14,14
3838,Evan Wessenberg,FR,2014-15,F,North Dakota State,Summit,17,80,7,15,7,14,0,1,0,2,5,4,9,4,2,1,5,10,14
3839,Dominic Woodson,SO,2014-15,F,Tennessee,SEC,4,48,6,12,6,12,0,0,2,6,3,5,8,1,3,2,3,12,14
3840,Clayton Custer,FR,2014-15,G,Iowa State,Big 12,12,69,3,15,0,5,3,10,4,4,1,4,5,8,4,0,3,6,13
3841,Justin Diecker,FR,2014-15,F,Kennesaw State,A-Sun,12,78,5,13,5,13,0,0,3,6,1,6,7,1,1,3,7,26,13
3842,Brady Ellingson,FR,2014-15,G,Iowa,Big Ten,7,32,4,8,0,2,4,6,1,2,0,0,0,4,1,0,1,1,13
3843,Jamel Flash,SR,2014-15,F,Towson,CAA,23,126,4,14,4,14,0,0,5,9,8,10,18,0,1,2,4,12,13
3844,Brenden Glapion,JR,2014-15,G,California,Pac-12,10,19,3,6,3,6,0,0,7,9,1,0,1,1,0,0,0,3,13
3845,Tab Hamilton,SR,2014-15,G,Appalachian State,Sun Belt,4,72,5,20,3,11,2,9,1,4,0,6,6,4,0,1,4,12,13
3846,Eric Johnson,FR,2014-15,G,Boston University,Patriot,12,110,4,14,3,7,1,7,4,9,0,7,7,6,4,0,8,7,13
3847,Jarred Jones,JR,2014-15,G,Loyola (MD),Patriot,2,40,4,12,4,12,0,0,5,9,4,11,15,3,2,3,10,6,13
3848,Eric Katenda,JR,2014-15,F,Notre Dame,ACC,15,32,4,17,4,17,0,0,5,9,1,6,7,1,1,1,1,3,13
3849,Jafar Kinsey,FR,2014-15,G,Robert Morris,NEC,11,157,5,23,2,10,3,13,0,4,2,10,12,10,3,0,13,18,13
3850,Daquein McNeil,SO,2014-15,G,Minnesota,Big Ten,4,75,5,19,4,12,1,7,2,8,5,8,13,10,3,0,3,12,13
3851,Obi Momah,FR,2014-15,F,Marist,MAAC,14,66,4,14,2,7,2,7,3,6,4,12,16,1,2,3,7,11,13
3852,Joshua Oswald,SO,2014-15,F,Miami (OH),MAC,12,75,5,17,5,12,0,5,3,4,5,10,15,5,4,1,3,8,13
3853,Mat Piotrowski,SR,2014-15,C,Eastern Illinois,OVC,17,97,6,19,5,9,1,10,0,1,1,21,22,0,2,12,3,9,13
3854,Christien Sager,SR,2014-15,G,Oklahoma State,Big 12,23,98,3,15,0,1,3,14,4,9,3,9,12,4,4,0,2,12,13
3855,Mike Schroback,FR,2014-15,G,Fairleigh Dickinson,NEC,20,63,5,12,2,5,3,7,0,1,0,0,0,4,2,0,3,1,13
3856,Ed Seay,SO,2014-15,F,Texas State,Sun Belt,9,45,6,13,6,11,0,2,1,2,1,6,7,2,0,3,4,5,13
3857,John Robert Simon,SO,2014-15,G,Wichita State,MVC,14,49,5,11,4,7,1,4,2,2,2,5,7,5,4,0,5,6,13
3858,Roman Sorkin,FR,2014-15,F,Oregon,Pac-12,8,35,5,11,3,5,2,6,1,2,1,7,8,1,0,1,3,2,13
3859,B.J. Stith,FR,2014-15,G,Virginia,ACC,13,63,5,13,4,7,1,6,2,3,0,8,8,4,2,0,3,2,13
3860,Jacquil Taylor,FR,2014-15,F,Purdue,Big Ten,6,42,5,11,4,7,1,4,2,4,3,9,12,2,1,4,6,1,13
3861,Robin Thompson,FR,2014-15,F,Missouri State,MVC,8,61,3,11,3,11,0,0,7,11,4,5,9,3,2,4,3,15,13
3862,Jared Walker,FR,2014-15,G,Wichita State,MVC,11,37,4,8,1,3,3,5,2,2,1,5,6,3,0,0,2,5,13
3863,Marcus White,SO,2014-15,G,Illinois-Chicago,Horizon,15,68,4,12,2,6,2,6,3,7,1,5,6,5,4,0,1,0,13
3864,Tanner Wozniak,SR,2014-15,G,Kennesaw State,A-Sun,21,135,4,15,0,1,4,14,1,2,1,9,10,4,2,0,11,12,13
3865,Marley Biyendolo,FR,2014-15,G,Pepperdine,WCC,21,102,5,14,4,11,1,3,1,4,1,5,6,9,5,1,12,13,12
3866,Pat Branin,SR,2014-15,G,College of Charleston,CAA,22,102,4,14,1,2,3,12,1,2,0,6,6,5,1,0,4,15,12
3867,Klint Carlson,FR,2014-15,F,Northern Iowa,MVC,19,60,3,7,1,5,2,2,4,6,3,6,9,2,1,0,2,3,12
3868,Aaron Cheatum,JR,2014-15,F,Washington State,Pac-12,16,92,4,14,4,13,0,1,4,15,7,11,18,3,4,2,4,13,12
3869,Myles Davis,SR,2014-15,G,Central Florida,AAC,18,73,5,10,3,4,2,6,0,1,0,6,6,4,4,3,4,16,12
3870,Alex Dragicevich,SR,2014-15,G,Boston College,ACC,18,91,4,10,0,2,4,8,0,0,2,7,9,3,2,2,3,6,12
3871,Trevor Dunbar,FR,2014-15,G,Washington State,Pac-12,16,157,5,22,3,16,2,6,0,2,1,6,7,24,4,0,17,12,12
3872,Jordan Faciane,JR,2014-15,G,Campbell,Big South,5,24,4,10,3,3,1,7,3,3,1,9,10,4,0,0,2,2,12
3873,Alan Flannigan,SR,2014-15,F,Lafayette,Patriot,18,61,4,14,3,8,1,6,3,4,1,10,11,3,0,1,4,9,12
3874,Rantavious Gilbert,JR,2014-15,F,Appalachian State,Sun Belt,17,80,6,18,6,18,0,0,0,2,7,12,19,2,1,6,5,12,12
3875,Derrell Joubert,FR,2014-15,G,McNeese State,Southland,8,17,4,9,0,1,4,8,0,0,0,3,3,0,0,0,0,2,12
3876,Connor MacDougall,FR,2014-15,F-C,Arizona State,Pac-12,6,23,4,4,4,4,0,0,4,5,0,4,4,0,0,2,0,7,12
3877,Ali Mackay,SR,2014-15,F,Davidson,A-10,18,66,4,6,3,4,1,2,3,4,2,6,8,5,3,0,2,5,12
3878,Jeff Martin,SO,2014-15,G,Murray State,OVC,10,24,3,12,1,5,2,7,4,6,0,3,3,1,1,0,0,1,12
3879,Daniel Norl,FR,2014-15,G,Eastern Kentucky,OVC,11,74,5,17,5,12,0,5,2,2,3,3,6,8,3,0,3,8,12
3880,Chauncy Parker,JR,2014-15,C,Arkansas-Pine Bluff,SWAC,25,176,4,13,4,12,0,1,4,6,3,16,19,12,8,15,14,22,12
3881,Jerrod Patton,JR,2014-15,F,Fresno State,MWC,9,27,6,8,6,8,0,0,0,1,1,7,8,1,1,1,2,1,12
3882,Jake Pemberton,FR,2014-15,G,Denver,Summit,17,126,5,21,3,10,2,11,0,0,2,8,10,8,2,0,5,19,12
3883,De'Vaughn Reid,SR,2014-15,G,Holy Cross,Patriot,16,109,4,20,4,16,0,4,4,5,1,10,11,10,1,0,11,5,12
3884,Juan Ramon Rivas,FR,2014-15,F,Missouri-Kansas City,WAC,8,57,4,19,3,12,1,7,3,3,4,2,6,2,2,0,4,3,12
3885,Grant Verhoeven,JR,2014-15,C,Stanford,Pac-12,8,92,5,12,5,12,0,0,2,4,10,8,18,4,3,4,3,16,12
3886,Kellen Blake,FR,2014-15,G,Winthrop,Big South,8,14,3,6,2,3,1,3,4,5,1,1,2,0,2,0,0,0,11
3887,Keon Burns,FR,2014-15,G,New Hampshire,AEC,7,14,3,5,1,2,2,3,3,4,0,1,1,0,0,0,2,2,11
3888,Lewis Cramer,JR,2014-15,F,Seattle,WAC,9,70,2,8,2,8,0,0,7,10,3,7,10,1,2,1,3,9,11
3889,Riley Dearring,FR,2014-15,G,Wisconsin,Big Ten,15,39,4,10,1,3,3,7,0,1,0,4,4,1,1,0,6,5,11
3890,Chris Egi,FR,2014-15,F,Harvard,Ivy,11,45,3,9,3,9,0,0,5,12,1,5,6,4,1,2,3,3,11
3891,Colin Gruber,SR,2014-15,F,California-Riverside,Big West,11,79,4,20,3,13,1,7,2,2,5,13,18,1,7,2,3,10,11
3892,Matt Hancock,JR,2014-15,G,Lamar,Southland,12,55,5,10,4,4,1,6,0,0,2,4,6,5,0,0,2,6,11
3893,Kevin Harden,SR,2014-15,G,IPFW,Summit,7,50,3,13,0,1,3,12,2,2,2,5,7,3,2,0,1,0,11
3894,Terrance LeFlore,SO,2014-15,G,Alabama State,SWAC,5,46,4,11,3,8,1,3,2,2,2,2,4,7,1,1,4,8,11
3895,Khalid McCaskill,JR,2014-15,G-F,Lehigh,Patriot,7,38,5,13,4,9,1,4,0,1,1,7,8,1,1,1,3,6,11
3896,Ryan McCoy,JR,2014-15,F,George Washington,A-10,28,99,5,11,4,9,1,2,0,1,4,4,8,1,1,3,5,21,11
3897,Corey Mendez,FR,2014-15,G,Stetson,A-Sun,9,82,3,18,0,3,3,15,2,2,0,5,5,6,0,1,8,10,11
3898,Ron Mvouika,SR,2014-15,G-F,Missouri State,MVC,2,20,4,9,3,6,1,3,2,4,0,4,4,1,2,0,3,0,11
3899,Devin Newsome,FR,2014-15,G,Nebraska-Omaha,Summit,27,173,4,19,2,9,2,10,1,5,4,9,13,16,6,0,5,13,11
3900,Aaron O'Neill,SR,2014-15,G,Furman,Southern,15,85,4,9,2,2,2,7,1,2,0,5,5,0,4,0,1,12,11
3901,Chauncey Orr,JR,2014-15,G-F,Bowling Green State,MAC,5,57,5,12,4,7,1,5,0,1,5,4,9,3,1,1,2,2,11
3902,Alex Prahl,FR,2014-15,F,Milwaukee,Horizon,21,94,4,5,4,5,0,0,3,10,5,7,12,2,0,0,4,19,11
3903,Khyan Rayner,SO,2014-15,G,Princeton,Ivy,18,60,3,9,2,2,1,7,4,10,0,3,3,3,3,0,4,10,11
3904,Kendal Shell,SR,2014-15,G,Minnesota,Big Ten,14,45,4,10,2,5,2,5,1,2,0,3,3,5,1,0,2,2,11
3905,Shamiek Sheppard,FR,2014-15,G-F,South Carolina,SEC,7,48,5,18,4,17,1,1,0,2,6,3,9,1,5,4,2,6,11
3906,Kadeem Smithen,FR,2014-15,G,Richmond,A-10,23,82,4,13,2,6,2,7,1,3,1,7,8,5,3,0,1,11,11
3907,Myles Tate,SO,2014-15,G,George Mason,A-10,13,72,4,13,1,6,3,7,0,0,6,8,14,6,3,0,6,16,11
3908,Khristian Taylor,SR,2014-15,G,Tennessee-Martin,OVC,16,43,4,8,2,4,2,4,1,2,1,13,14,3,1,0,1,2,11
3909,DeMarcus Threatt,JR,2014-15,G,Fairfield,MAAC,4,21,3,5,2,4,1,1,4,7,1,0,1,3,0,0,1,2,11
3910,T.J. Traylor,JR,2014-15,F,Texas A&amp;M-Corpus Christi,Southland,12,99,3,11,3,11,0,0,5,13,6,14,20,3,1,5,1,17,11
3911,Georgios Tsalmpouris,FR,2014-15,F-C,Iowa State,Big 12,8,35,4,10,2,6,2,4,1,5,2,4,6,2,1,0,3,1,11
3912,Ashley Williams,FR,2014-15,G,Western Carolina,Southern,16,68,4,11,2,5,2,6,1,2,3,4,7,2,4,1,2,8,11
3913,Zach Yoshor,FR,2014-15,G,Harvard,Ivy,9,17,4,8,1,4,3,4,0,0,1,3,4,0,0,0,1,2,11
3914,Georgios Angelou,SO,2014-15,G,Saint Francis (PA),NEC,6,28,3,6,1,2,2,4,2,2,0,1,1,1,0,0,3,5,10
3915,Travis Avery,JR,2014-15,C,New Orleans,Southland,14,40,4,7,4,7,0,0,2,6,0,3,3,1,1,0,2,9,10
3916,Alijah Bennett,SO,2014-15,G,Kennesaw State,A-Sun,17,66,4,14,4,8,0,6,2,2,2,7,9,7,0,1,8,7,10
3917,Marcus Blake,SR,2014-15,F,Florida Gulf Coast,A-Sun,16,54,4,11,4,11,0,0,2,3,5,9,14,3,0,0,4,3,10
3918,Hans Christian Lauer,SO,2014-15,F,Illinois-Chicago,Horizon,14,55,3,10,3,6,0,4,4,6,0,10,10,0,0,0,1,6,10
3919,Matt Cimino,FR,2014-15,F,George Washington,A-10,28,56,5,14,5,11,0,3,0,3,4,7,11,1,0,0,3,8,10
3920,Keondre Dew,FR,2014-15,G,Tulsa,AAC,21,115,5,24,5,22,0,2,0,1,11,21,32,3,1,0,10,12,10
3921,Khadim Dieng,FR,2014-15,C,Western Michigan,MAC,12,53,4,7,4,7,0,0,2,6,1,10,11,1,0,2,3,8,10
3922,Devin Epps,FR,2014-15,G,South Alabama,Sun Belt,12,25,3,4,0,1,3,3,1,3,0,2,2,1,0,0,3,6,10
3923,Austin Evans,FR,2014-15,F,Texas State,Sun Belt,9,29,4,8,4,8,0,0,2,7,1,6,7,0,0,1,2,3,10
3924,Deion Giddens,SR,2014-15,F-C,Cornell,Ivy,25,164,4,13,4,13,0,0,2,3,15,11,26,0,2,10,2,20,10
3925,Kenny Grant,FR,2014-15,F,Rider,MAAC,24,92,5,14,5,14,0,0,0,3,7,12,19,0,2,4,9,19,10
3926,Joe Hanel,FR,2014-15,F,DePaul,Big East,15,60,4,7,4,6,0,1,2,2,2,3,5,2,3,2,0,4,10
3927,Kevin Hickson,JR,2014-15,F,North Carolina-Wilmington,CAA,16,74,4,7,4,7,0,0,2,5,3,6,9,0,6,4,2,17,10
3928,Logan Jackson,FR,2014-15,G,Appalachian State,Sun Belt,10,53,5,10,5,5,0,5,0,2,2,1,3,4,0,0,3,8,10
3929,Larry Johnson,JR,2014-15,G,Arkansas-Pine Bluff,SWAC,20,58,4,10,2,6,2,4,0,0,1,2,3,3,2,0,7,7,10
3930,Gene Langan,FR,2014-15,F,Furman,Southern,9,29,4,7,4,7,0,0,2,2,4,6,10,0,0,0,2,2,10
3931,Aaron Liberman,FR,2014-15,C,Tulane,AAC,13,45,5,7,5,7,0,0,0,2,3,2,5,2,1,3,2,8,10
3932,Max Livingston,JR,2014-15,G-F,Portland,WCC,12,52,3,11,1,3,2,8,2,2,0,2,2,4,1,0,1,3,10
3933,Shelby Moats,SR,2014-15,F,Vanderbilt,SEC,9,38,4,7,4,6,0,1,2,5,4,5,9,1,1,0,4,4,10
3934,Viko Noma'aea,SO,2014-15,G,Utah State,MWC,14,72,3,16,2,6,1,10,3,4,2,5,7,3,5,0,3,5,10
3935,Chinonso Obokoh,SO,2014-15,C,Syracuse,ACC,13,89,4,6,4,6,0,0,2,4,10,11,21,3,3,4,1,19,10
3936,Robert Ojeah,JR,2014-15,C,Alabama State,SWAC,8,40,4,9,4,9,0,0,2,2,4,8,12,0,1,3,4,10,10
3937,Mark Pollack,FR,2014-15,F,Army,Patriot,10,41,4,16,2,5,2,11,0,0,0,7,7,1,0,1,4,6,10
3938,Kris Rolle,SR,2014-15,G,Saint Peter's,MAAC,19,77,4,10,4,10,0,0,2,10,8,12,20,1,2,0,1,12,10
3939,Mawdo Sallah,FR,2014-15,C,Mount St. Mary's,NEC,15,99,5,10,5,10,0,0,0,3,8,10,18,2,0,11,3,16,10
3940,Brandon St. Louis,SR,2014-15,F,Coppin State,MEAC,13,101,4,17,4,17,0,0,2,4,11,11,22,3,5,2,4,22,10
3941,Eric Stafford,FR,2014-15,G,Lafayette,Patriot,16,60,4,11,2,5,2,6,0,0,5,3,8,4,2,3,8,8,10
3942,D.J. Suter,SR,2014-15,G,Georgia Southern,Sun Belt,7,24,4,9,2,3,2,6,0,0,1,4,5,1,0,2,0,1,10
3943,Anthony Swan,FR,2014-15,G-F,George Washington,A-10,26,46,4,9,2,3,2,6,0,2,1,7,8,0,1,0,3,5,10
3944,Quincy Tillinghast,FR,2014-15,G,Delaware State,MEAC,7,32,3,11,1,2,2,9,2,3,1,3,4,5,1,0,4,1,10
3945,Demetrius Treadwell,SR,2014-15,F,Akron,MAC,1,28,4,7,4,7,0,0,2,6,3,10,13,3,0,0,2,1,10
3946,Conor Voss,SO,2014-15,C,Columbia,Ivy,19,61,3,9,3,9,0,0,4,6,2,12,14,1,0,0,5,13,10
3947,Aubrey Williams,SO,2014-15,F,Toledo,MAC,16,41,4,10,4,9,0,1,2,5,5,5,10,0,0,1,5,8,10
3948,Devin Wyatt,FR,2014-15,F,Loyola Marymount,WCC,16,76,2,9,2,8,0,1,6,10,3,4,7,0,1,1,2,16,10
3949,Khalil Bedart-Ghani,FR,2014-15,,San Diego,WCC,6,32,4,8,4,8,0,0,1,2,0,2,2,0,1,1,1,1,9
3950,Steven Bennett,SO,2014-15,G,Butler,Big East,9,25,3,7,0,1,3,6,0,0,1,1,2,2,0,0,1,4,9
3951,Tanveer Bhullar,FR,2014-15,C,New Mexico State,WAC,10,43,4,11,4,11,0,0,1,2,1,2,3,2,1,2,3,7,9
3952,Sean Billerman,SR,2014-15,G-F,Army,Patriot,7,17,2,7,1,1,1,6,4,5,0,1,1,2,0,0,0,1,9
3953,Dylan Brossman,SO,2014-15,G,Boston University,Patriot,20,129,2,12,1,3,1,9,4,4,3,5,8,18,5,0,4,10,9
3954,Jake Campbell,SO,2014-15,C,Presbyterian,Big South,12,78,3,6,3,6,0,0,3,4,1,8,9,2,0,0,3,8,9
3955,Chris Carter,SR,2014-15,F,Long Island University,NEC,10,35,4,8,4,8,0,0,1,2,5,5,10,0,2,3,3,7,9
3956,Elex Carter,SO,2014-15,F,Southern,SWAC,10,55,4,10,4,10,0,0,1,2,10,11,21,0,0,5,8,14,9
3957,Denzel Collins,SR,2014-15,G,Alabama-Birmingham,CUSA,9,27,3,8,2,4,1,4,2,3,0,2,2,3,2,0,2,6,9
3958,Cameron Curry,JR,2014-15,G,Boston University,Patriot,20,129,2,12,1,3,1,9,4,4,,,8,18,5,,,,9
3959,Joey De La Rosa,JR,2014-15,C,St. John's (NY),Big East,18,85,4,10,4,10,0,0,1,7,6,10,16,0,1,3,3,20,9
3960,Larry Dennis,FR,2014-15,F,Florida International,CUSA,9,74,4,12,4,9,0,3,1,4,2,12,14,2,2,0,5,12,9
3961,DayJar Dickson,FR,2014-15,F,Niagara,MAAC,18,140,3,15,3,15,0,0,3,7,8,11,19,4,4,4,7,18,9
3962,Sherron Dorsey-Walker,SO,2014-15,G,Iowa State,Big 12,3,39,3,8,2,4,1,4,2,2,0,4,4,1,1,0,1,0,9
3963,Treaven Duffy,SO,2014-15,G,Saint Mary's (CA),WCC,21,65,4,14,4,11,0,3,1,4,5,6,11,3,3,0,9,9,9
3964,Daniel Edwards,SR,2014-15,F,Princeton,Ivy,12,25,3,7,2,4,1,3,2,2,2,3,5,1,0,0,3,0,9
3965,Rodney Elliott,SO,2014-15,G,Maryland-Baltimore County,AEC,2,21,3,8,1,2,2,6,1,2,0,3,3,3,0,0,2,0,9
3966,Dyrbe Enos,SO,2014-15,G,Hawaii,Big West,18,44,3,17,0,3,3,14,0,2,0,1,1,3,1,0,3,2,9
3967,Tevin Findlay,SO,2014-15,G,Green Bay,Horizon,17,73,3,15,3,13,0,2,3,3,3,7,10,10,3,0,3,7,9
3968,Chase Foster,FR,2014-15,F,San Francisco,WCC,9,38,3,14,2,6,1,8,2,4,2,6,8,1,0,0,3,5,9
3969,Leon Gilmore,FR,2014-15,F,Creighton,Big East,8,39,1,7,0,4,1,3,6,10,2,7,9,3,0,0,3,5,9
3970,Connor Griffin,SO,2014-15,F,Gonzaga,WCC,14,52,3,6,3,6,0,0,3,6,2,6,8,1,3,2,2,10,9
3971,Kyle Haber,FR,2014-15,F,Brown,Ivy,6,56,3,8,0,3,3,5,0,2,1,3,4,1,2,1,0,3,9
3972,Nathan Harries,SO,2014-15,G,Colgate,Patriot,4,56,3,10,2,6,1,4,2,2,0,3,3,2,0,0,1,12,9
3973,Gregory Hayden,SO,2014-15,G,Hampton,MEAC,13,26,2,8,2,5,0,3,5,9,2,2,4,5,3,0,7,3,9
3974,Aaron Hendricks,SO,2014-15,G,Pacific,WCC,6,22,3,10,0,1,3,9,0,0,1,2,3,1,1,0,1,1,9
3975,Mitch Hill,FR,2014-15,F,Winthrop,Big South,10,23,2,10,0,0,2,10,3,4,1,3,4,3,0,2,2,0,9
3976,Gavin Hoffmann,SR,2014-15,G,San Francisco,WCC,17,77,2,7,2,6,0,1,5,8,1,11,12,4,1,0,3,6,9
3977,Billy Ingram,SO,2014-15,G-F,Alabama State,SWAC,6,25,3,11,0,2,3,9,0,0,1,3,4,0,0,0,2,5,9
3978,Nick Kerr,JR,2014-15,G,San Diego,WCC,6,22,3,8,0,2,3,6,0,0,0,1,1,0,0,0,0,2,9
3979,Aaron Leblanc,SR,2014-15,F,Louisiana-Lafayette,Sun Belt,11,43,4,10,4,10,0,0,1,2,4,4,8,2,0,6,5,4,9
3980,Deng Leek,JR,2014-15,C,Southern Illinois,MVC,12,57,4,5,4,5,0,0,1,5,0,6,6,2,0,8,1,8,9
3981,Jimmy Marshall,SO,2014-15,G-F,Northeastern,CAA,17,62,2,13,1,4,1,9,4,5,3,6,9,2,0,0,1,4,9
3982,Josh Martin,FR,2014-15,F,Minnesota,Big Ten,7,38,3,7,3,6,0,1,3,9,2,5,7,0,0,3,6,4,9
3983,Karim Mawuenyega,SO,2014-15,G,South Carolina Upstate,A-Sun,3,40,3,10,2,4,1,6,2,5,2,3,5,9,7,0,0,2,9
3984,Montana Mayfield,SO,2014-15,G,NJIT,Ind,5,48,3,9,3,6,0,3,3,4,0,4,4,4,0,1,3,4,9
3985,Ben Milshtein,JR,2014-15,F,Mississippi Valley State,SWAC,10,68,2,13,2,12,0,1,5,9,5,6,11,2,1,0,2,9,9
3986,Devin Mitchell,FR,2014-15,G,Alabama,SEC,14,76,3,23,1,6,2,17,1,2,0,3,3,4,3,1,2,15,9
3987,Tyre Moore,FR,2014-15,G,Mercer,Southern,15,25,1,4,0,1,1,3,6,8,6,2,8,0,1,0,1,7,9
3988,Kyler Neilson,FR,2014-15,F,Southern Utah,Big Sky,4,17,3,5,2,2,1,3,2,2,0,1,1,2,1,0,0,2,9
3989,Michael Onyebalu,FR,2014-15,G,California-Davis,Big West,4,17,4,7,3,5,1,2,0,0,0,0,0,0,0,0,3,2,9
3990,Jack Purchase,FR,2014-15,F,Auburn,SEC,7,91,3,14,0,1,3,13,0,0,2,6,8,4,1,0,2,15,9
3991,Nick Reese,FR,2014-15,F,North Carolina A&amp;T,MEAC,16,74,4,15,3,7,1,8,0,0,5,8,13,4,3,2,9,11,9
3992,Matt Rosenwinkel,SO,2014-15,G,Northern Kentucky,A-Sun,10,43,3,11,0,1,3,10,0,0,2,4,6,1,0,0,1,5,9
3993,Ismael Sanogo,FR,2014-15,G,Seton Hall,Big East,18,96,3,12,3,10,0,2,3,9,7,11,18,1,4,8,5,17,9
3994,J.T. Trauber,FR,2014-15,G,Rice,CUSA,6,9,3,3,0,0,3,3,0,0,1,0,1,0,0,0,0,1,9
3995,Dustin Triano,FR,2014-15,G,Gonzaga,WCC,11,31,3,6,0,0,3,6,0,0,1,3,4,0,1,0,2,4,9
3996,Andrew Vollert,SO,2014-15,F,San Jose State,MWC,3,56,4,7,3,6,1,1,0,0,1,2,3,0,0,0,2,5,9
3997,Cole Walton,SO,2014-15,C,Sacred Heart,NEC,5,55,4,10,4,10,0,0,1,2,6,7,13,1,1,1,3,5,9
3998,Austin Williams,FR,2014-15,F,Drexel,CAA,20,211,4,10,4,10,0,0,1,5,7,26,33,6,3,8,6,34,9
3999,Corey Young,SR,2014-15,F,Alcorn State,SWAC,9,62,3,11,0,1,3,10,0,0,1,2,3,2,1,0,0,8,9
4000,Tyler Akers,SR,2014-15,G,Longwood,Big South,11,23,2,6,1,1,1,5,3,4,1,1,2,1,0,0,3,1,8
4001,Andrew Bargmann,SO,2014-15,G,Colgate,Patriot,4,13,3,5,2,2,1,3,1,1,0,1,1,1,2,0,2,0,8
4002,Staats Battle,SR,2014-15,G,North Carolina State,ACC,5,11,3,8,1,1,2,7,0,0,2,1,3,0,0,0,0,3,8
4003,Jack Bentz,SR,2014-15,G,Wyoming,MWC,22,183,2,18,2,12,0,6,4,6,1,18,19,25,4,0,6,8,8
4004,Josh Bougher,FR,2014-15,G,Tennessee Tech,OVC,6,22,3,9,2,5,1,4,1,1,1,3,4,1,1,0,0,2,8
4005,Ryan Burton,JR,2014-15,F,Indiana,Big Ten,14,49,4,4,4,4,0,0,0,0,4,6,10,3,0,0,0,7,8
4006,Robert Cid,SR,2014-15,G,Cal State Northridge,Big West,10,19,2,7,1,3,1,4,3,4,1,1,2,0,1,0,2,5,8
4007,Damarcus Croaker,SO,2014-15,G,Texas,Big 12,5,47,3,10,1,1,2,9,0,0,2,3,5,3,0,0,3,2,8
4008,Gaston Diedhiou,FR,2014-15,F,Minnesota,Big Ten,13,68,4,9,4,5,0,4,0,1,4,5,9,0,0,0,5,9,8
4009,Josh Forney,SO,2014-15,F,Loyola (MD),Patriot,18,58,3,4,3,4,0,0,2,10,4,5,9,0,4,1,5,11,8
4010,Nate Gehring,FR,2014-15,C,Pepperdine,WCC,13,97,3,7,3,7,0,0,2,2,3,12,15,4,6,1,3,4,8
4011,Sam Hershberger,JR,2014-15,G,Elon,CAA,5,15,2,3,1,1,1,2,3,3,1,3,4,3,1,0,0,4,8
4012,Brian Hornstein,SR,2014-15,C,Florida Atlantic,CUSA,14,66,4,15,4,14,0,1,0,0,4,2,6,0,2,4,2,9,8
4013,Julien Johnson,SO,2014-15,F,North Carolina A&amp;T,MEAC,9,20,2,7,1,2,1,5,3,4,4,1,5,0,1,0,1,3,8
4014,Kevin Kaspar,SR,2014-15,G,Western Kentucky,CUSA,4,40,2,9,0,2,2,7,2,2,0,2,2,3,1,0,1,3,8
4015,Josh Lester,FR,2014-15,F,Belmont,OVC,14,43,3,9,3,8,0,1,2,5,1,8,9,1,0,0,2,10,8
4016,Kievyn Lila-St. Rose,SR,2014-15,G-F,Norfolk State,MEAC,11,61,3,11,2,2,1,9,1,1,0,9,9,3,2,1,4,7,8
4017,Damarkeo Lyshe,SR,2014-15,G,Bowling Green State,MAC,14,54,2,11,0,5,2,6,2,4,2,2,4,3,2,0,2,6,8
4018,Ausar Madison,SO,2014-15,G,Howard,MEAC,4,37,3,7,1,4,2,3,0,1,2,4,6,7,3,0,3,4,8
4019,Spencer Mathis,FR,2014-15,F,Northern Colorado,Big Sky,9,73,2,10,2,5,0,5,4,14,3,3,6,4,0,0,5,13,8
4020,George Matthews,JR,2014-15,G,Texas-San Antonio,CUSA,8,33,3,9,3,5,0,4,2,2,2,6,8,0,3,0,5,5,8
4021,Ba'shawn Mickens,FR,2014-15,G,Monmouth,MAAC,12,14,3,5,1,1,2,4,0,0,0,0,0,1,0,0,1,0,8
4022,Andrija Milovanovic,SO,2014-15,F,McNeese State,Southland,12,41,2,9,0,3,2,6,2,2,1,2,3,2,0,0,1,3,8
4023,Billy Murphy,JR,2014-15,F,Lafayette,Patriot,10,17,3,8,1,3,2,5,0,0,0,1,1,1,1,0,1,1,8
4024,Brian Oddo,JR,2014-15,F,Miami (OH),MAC,8,38,4,8,4,5,0,3,0,0,1,0,1,0,2,0,0,3,8
4025,Charles Oliver,SR,2014-15,G,Robert Morris,NEC,2,19,0,7,0,3,0,4,8,10,2,2,4,1,1,0,0,5,8
4026,Michael Oyefusi,JR,2014-15,F,Coppin State,MEAC,4,13,2,5,0,0,2,5,2,2,0,4,4,1,0,0,2,1,8
4027,Jonas Page,SO,2014-15,F,Florida International,CUSA,5,10,3,7,1,2,2,5,0,0,0,0,0,0,0,1,0,0,8
4028,Georgios Pilitsis,SO,2014-15,G,Lehigh,Patriot,4,14,2,4,0,0,2,4,2,2,0,2,2,3,1,1,0,2,8
4029,Varun Ram,SR,2014-15,G,Maryland,Big Ten,21,57,0,5,0,1,0,4,8,8,0,5,5,3,3,0,6,8,8
4030,John Rinaldi,SO,2014-15,G,Binghamton,AEC,19,98,2,7,2,7,0,0,4,7,7,6,13,3,5,1,3,12,8
4031,Charles Rushman,SO,2014-15,G,Nevada-Las Vegas,MWC,5,16,3,5,3,4,0,1,2,2,0,1,1,2,1,0,0,3,8
4032,Cameron Smith,FR,2014-15,F,Dartmouth,Ivy,16,53,3,13,2,9,1,4,1,3,1,3,4,2,1,0,2,7,8
4033,Edmond Sumner,FR,2014-15,G,Xavier,Big East,6,43,2,10,2,7,0,3,4,6,2,3,5,6,2,0,5,9,8
4034,David Travers,FR,2014-15,G,Georgia State,Sun Belt,4,20,2,2,0,0,2,2,2,3,0,2,2,1,1,0,2,2,8
4035,Malcolm Walters,FR,2014-15,G,Akron,MAC,14,59,2,11,1,4,1,7,3,8,1,6,7,5,1,1,8,10,8
4036,Mason Wedel,SO,2014-15,G,Missouri-Kansas City,WAC,7,55,2,9,0,1,2,8,2,2,4,1,5,4,4,0,3,6,8
4037,Dougal Weir,SO,2014-15,C,Hartford,AEC,16,57,4,10,4,10,0,0,0,0,4,6,10,1,0,1,3,11,8
4038,Jabrille Williams,SR,2014-15,F,Binghamton,AEC,10,47,4,10,4,9,0,1,0,3,2,8,10,0,1,0,2,8,8
4039,Drew Wilson,JR,2014-15,F,Oral Roberts,Summit,6,75,4,8,4,8,0,0,0,2,8,11,19,0,5,5,2,20,8
4040,Nolan Wilson,SO,2014-15,F,Prairie View,SWAC,24,151,4,11,4,11,0,0,0,3,10,14,24,5,2,6,7,31,8
4041,Luke Adams,SR,2014-15,G,Texas Tech,Big 12,13,40,0,5,0,3,0,2,7,9,2,3,5,3,1,0,4,4,7
4042,Winslo Barry,SR,2014-15,F,Incarnate Word,Southland,21,73,3,13,3,13,0,0,1,8,8,16,24,0,3,3,2,19,7
4043,Jake Bodway,FR,2014-15,G,South Florida,AAC,15,32,3,7,2,6,1,1,0,0,0,0,0,1,1,0,2,4,7
4044,Ryder Bowline,SO,2014-15,G,Elon,CAA,3,10,3,5,2,2,1,3,0,1,1,2,3,0,0,0,1,1,7
4045,Gabe Brown,FR,2014-15,C,American,Patriot,12,45,2,12,2,12,0,0,3,4,5,2,7,3,0,5,4,4,7
4046,Torey Burston,SO,2014-15,G,Virginia Commonwealth,A-10,14,35,1,5,0,1,1,4,4,6,0,4,4,6,3,0,0,3,7
4047,Dorian Cason,JR,2014-15,F,Portland State,Big Sky,3,27,2,6,2,6,0,0,3,4,4,2,6,0,0,1,2,3,7
4048,Jacob Casper,SO,2014-15,G,North Carolina-Asheville,Big South,7,25,3,5,2,2,1,3,0,0,1,3,4,1,0,0,1,1,7
4049,Doug Chappell,SO,2014-15,G,Fairfield,MAAC,5,32,2,13,2,6,0,7,3,8,0,1,1,0,1,0,3,4,7
4050,Kyle Denning,SR,2014-15,G,Iowa,Big Ten,9,25,3,7,2,2,1,5,0,0,1,1,2,1,1,0,1,1,7
4051,Zacarry Douglas,FR,2014-15,F,Cal State Northridge,Big West,2,29,3,5,2,4,1,1,0,1,2,6,8,1,1,0,0,4,7
4052,Austin Eastman,SR,2014-15,G,Utah,Pac-12,19,40,1,6,0,3,1,3,4,6,2,4,6,0,2,1,3,4,7
4053,Kamau Faines,FR,2014-15,G,Davidson,A-10,7,8,2,2,1,1,1,1,2,5,0,0,0,0,0,0,1,0,7
4054,Daryl Fowlkes,SO,2014-15,G,Hofstra,CAA,8,19,2,5,1,4,1,1,2,2,0,0,0,1,0,0,1,1,7
4055,Georgi Funtarov,SO,2014-15,F,California-Davis,Big West,6,25,2,7,1,3,1,4,2,2,0,7,7,0,1,0,2,4,7
4056,Trevor Glassman,SO,2014-15,G,Manhattan,MAAC,11,26,2,11,0,0,2,11,1,2,1,0,1,0,0,0,2,6,7
4057,Ge'Lawn Guyn,SR,2014-15,G,Cincinnati,AAC,2,43,3,13,2,7,1,6,0,2,1,3,4,3,0,0,1,4,7
4058,Dylan Haines,FR,2014-15,F,Boston University,Patriot,14,79,3,13,2,7,1,6,0,2,6,4,10,0,1,2,8,13,7
4059,Bassel Harfouch,JR,2014-15,G,Alcorn State,SWAC,7,43,3,14,2,5,1,9,0,0,2,7,9,0,1,0,2,0,7
4060,John Hawkins,JR,2014-15,C,Miami (OH),MAC,8,34,3,8,3,7,0,1,1,2,1,7,8,0,1,0,1,2,7
4061,Desmond Hubert,SR,2014-15,F,North Carolina,ACC,21,81,2,5,2,5,0,0,3,9,10,12,22,1,1,1,6,14,7
4062,Marcanvis Hymon,FR,2014-15,F,Mississippi,SEC,6,51,3,5,3,5,0,0,1,2,2,5,7,3,2,2,4,9,7
4063,Trevis Jackson,SO,2014-15,G,Sacramento State,Big Sky,12,25,2,5,1,3,1,2,2,2,0,2,2,3,3,0,1,2,7
4064,Jared Klein,JR,2014-15,G,Western Michigan,MAC,10,53,3,7,3,6,0,1,1,2,0,1,1,1,2,0,0,1,7
4065,James Long,SO,2014-15,G,West Virginia,Big 12,10,21,3,6,2,3,1,3,0,0,1,1,2,0,0,0,0,2,7
4066,Christian McCoggle,SO,2014-15,C,Texas Southern,SWAC,10,94,2,6,2,6,0,0,3,9,12,16,28,2,1,4,3,16,7
4067,Reed McConnell,JR,2014-15,G,California-Irvine,Big West,12,44,3,11,2,7,1,4,0,1,0,3,3,3,0,0,1,6,7
4068,Malcolm McMillan,SR,2014-15,G,Central Connecticut State,NEC,2,60,1,15,0,8,1,7,4,4,1,6,7,7,1,1,5,7,7
4069,Jamal Mitchell,SR,2014-15,G-F,North Carolina-Greensboro,Southern,3,32,2,5,1,4,1,1,2,2,1,0,1,2,0,0,0,5,7
4070,Nathaniel Musters,JR,2014-15,C,Lafayette,Patriot,24,109,3,5,3,5,0,0,1,3,5,11,16,1,4,3,3,16,7
4071,Jake Ness,SR,2014-15,F,Boise State,MWC,20,88,2,5,2,3,0,2,3,4,2,12,14,3,2,1,3,13,7
4072,Grant O'Brien,JR,2014-15,F,Wake Forest,ACC,13,26,3,6,2,4,1,2,0,0,2,2,4,0,0,0,0,3,7
4073,Alex Paquin,FR,2014-15,G,American,Patriot,13,48,3,8,2,4,1,4,0,2,1,4,5,0,1,0,5,8,7
4074,Jay Parker,SR,2014-15,G,Illinois-Chicago,Horizon,5,44,1,10,1,8,0,2,5,6,1,3,4,5,2,0,4,3,7
4075,Bobby Perez,FR,2014-15,G,Wofford,Southern,7,15,2,4,1,3,1,1,2,4,0,0,0,0,1,0,3,2,7
4076,Connor Perkey,JR,2014-15,F,Davidson,A-10,8,15,2,3,1,2,1,1,2,2,0,1,1,0,0,0,1,3,7
4077,Cole Renninger,SO,2014-15,G,Lehigh,Patriot,12,23,2,9,2,8,0,1,3,5,2,2,4,2,0,0,0,5,7
4078,Jalen Sanders,FR,2014-15,G,Appalachian State,Sun Belt,7,25,3,8,2,5,1,3,0,0,0,2,2,4,0,0,2,1,7
4079,Sasha Seymore,SR,2014-15,F,North Carolina,ACC,6,11,2,4,2,4,0,0,3,4,1,1,2,0,0,0,3,2,7
4080,Charles Smith,SO,2014-15,C,Lipscomb,A-Sun,17,68,3,7,3,7,0,0,1,5,7,4,11,1,0,4,1,7,7
4081,Mason Stuteville,FR,2014-15,F,Sacramento State,Big Sky,7,19,3,11,3,7,0,4,1,3,1,7,8,0,0,1,3,6,7
4082,Blake Vedder,SR,2014-15,C,Kent State,MAC,13,13,3,6,2,2,1,4,0,0,0,1,1,0,0,0,2,2,7
4083,Tourron Whitfield,SR,2014-15,G,Marist,MAAC,15,32,1,5,0,1,1,4,4,4,0,1,1,1,0,0,1,5,7
4084,Jonathan Wilfong,SO,2014-15,G,Southern Methodist,AAC,7,22,3,6,3,4,0,2,1,2,2,1,3,1,1,0,2,1,7
4085,Kibret Woldemichael,SO,2014-15,G,San Diego State,MWC,6,14,2,3,0,0,2,3,1,2,1,1,2,0,1,0,3,0,7
4086,Zach Young,FR,2014-15,G,Nicholls State,Southland,17,180,1,13,1,9,0,4,5,10,2,8,10,19,2,0,14,11,7
4087,Jeremiah April,FR,2014-15,C,Indiana,Big Ten,4,17,3,3,3,3,0,0,0,0,1,4,5,1,1,2,1,4,6
4088,Marcus Brock,SO,2014-15,G,Incarnate Word,Southland,7,9,1,1,0,0,1,1,3,3,2,1,3,1,0,0,1,0,6
4089,Kentrall Brooks,SO,2014-15,F,Marist,MAAC,22,180,2,18,2,14,0,4,2,3,11,25,36,14,3,6,18,39,6
4090,Tim Broom,FR,2014-15,G,Citadel,Southern,14,91,0,11,0,6,0,5,6,14,0,4,4,18,7,0,11,13,6
4091,Chass Bryan,JR,2014-15,G,Southern California,Pac-12,18,104,1,16,1,14,0,2,4,8,4,8,12,15,6,1,6,21,6
4092,Keith Carroll,FR,2014-15,G,Hampton,MEAC,12,58,2,4,2,4,0,0,2,4,1,4,5,5,3,0,6,5,6
4093,Ernest Carter,FR,2014-15,G,Florida A&amp;M,MEAC,7,10,2,5,0,1,2,4,0,0,0,1,1,0,0,0,0,2,6
4094,Michael Clark,FR,2014-15,F,Saint Francis (PA),NEC,12,43,2,8,2,7,0,1,2,6,1,5,6,0,2,1,5,9,6
4095,Jalen Courtney,JR,2014-15,F,Morehead State,OVC,5,27,3,10,3,7,0,3,0,0,3,4,7,1,2,0,1,6,6
4096,Jeremiah Curtis,FR,2014-15,F,Morgan State,MEAC,12,47,1,9,1,9,0,0,4,4,2,3,5,1,1,0,1,9,6
4097,Matt Dahlen,FR,2014-15,F,Oregon State,Pac-12,13,58,3,5,3,5,0,0,0,4,4,4,8,2,2,0,3,15,6
4098,Jackie Davis,FR,2014-15,G,Washington State,Pac-12,11,56,2,12,2,4,0,8,2,7,1,4,5,0,1,1,6,6,6
4099,Kye de Laveaga,FR,2014-15,G,Northern Arizona,Big Sky,4,20,2,7,0,1,2,6,0,0,1,1,2,0,0,0,3,4,6
4100,Dan Dwyer,FR,2014-15,F,Pennsylvania,Ivy,16,65,3,5,3,5,0,0,0,0,2,11,13,1,1,2,1,4,6
4101,A.J. Edwards,SO,2014-15,G,Yale,Ivy,5,29,1,7,0,0,1,7,3,4,2,3,5,4,0,0,0,4,6
4102,Grant Ellis,SO,2014-15,G-F,Iona,MAAC,7,26,2,6,0,1,2,5,0,0,0,3,3,1,0,0,2,4,6
4103,Matt Fox,FR,2014-15,G,Bowling Green State,MAC,15,54,2,9,0,1,2,8,0,0,1,4,5,2,0,0,2,3,6
4104,Trent Gilbert,FR,2014-15,G,Louisville,ACC,4,16,2,6,0,1,2,5,0,0,1,1,2,2,0,0,2,3,6
4105,Egi Gjikondi,SO,2014-15,F,Houston,AAC,9,38,2,9,2,9,0,0,2,4,8,4,12,2,0,2,4,13,6
4106,Dan Guest,JR,2014-15,G,Connecticut,AAC,9,20,2,4,2,3,0,1,2,2,0,1,1,2,0,0,3,3,6
4107,Charles Harris,SO,2014-15,G-F,Western Michigan,MAC,6,19,3,8,3,8,0,0,0,0,1,2,3,0,0,0,1,1,6
4108,T.K. Hayes,SO,2014-15,G,Furman,Southern,6,15,1,4,1,2,0,2,4,4,0,0,0,2,0,0,3,0,6
4109,Daniel Hill,JR,2014-15,G,Eastern Washington,Big Sky,15,49,2,9,2,3,0,6,2,2,0,3,3,2,2,0,3,7,6
4110,C.J. Holmes,JR,2014-15,G,Auburn,SEC,5,6,2,2,0,0,2,2,0,0,0,0,0,0,0,0,0,0,6
4111,Tony Jacob,SR,2014-15,F,Alabama State,SWAC,7,14,2,4,2,4,0,0,2,7,3,1,4,1,0,0,3,3,6
4112,Brandon Jawato,JR,2014-15,G,Hawaii,Big West,6,30,1,6,0,1,1,5,3,7,0,3,3,1,1,0,1,5,6
4113,Zach Korkowski,JR,2014-15,F,Wofford,Southern,7,15,2,5,2,4,0,1,2,2,0,5,5,2,0,0,0,4,6
4114,Ami Lakoju,FR,2014-15,F,California-Santa Barbara,Big West,3,27,3,6,3,6,0,0,0,0,0,4,4,0,0,0,0,5,6
4115,Tony Larkins,SR,2014-15,G,Central Michigan,MAC,7,16,3,3,3,3,0,0,0,0,0,2,2,1,1,0,1,3,6
4116,Malcolm Laws,FR,2014-15,G,Florida Atlantic,CUSA,4,11,2,4,1,1,1,3,1,2,2,1,3,0,0,0,1,1,6
4117,Mike LeBlanc,FR,2014-15,F,Princeton,Ivy,3,9,2,2,0,0,2,2,0,0,0,0,0,1,0,0,0,0,6
4118,Dylan Livesay,FR,2014-15,G,Oregon State,Pac-12,18,68,2,9,0,2,2,7,0,0,0,2,2,4,0,0,2,3,6
4119,Lake Lutes,FR,2014-15,F,Air Force,MWC,4,10,2,4,0,1,2,3,0,0,0,0,0,0,0,0,0,3,6
4120,Rashaun Madison,JR,2014-15,G,North Carolina Central,MEAC,6,55,2,11,0,3,2,8,0,0,1,7,8,7,2,0,9,6,6
4121,Jason Martin,SO,2014-15,G,Stephen F. Austin,Southland,13,26,3,6,3,3,0,3,0,0,2,3,5,1,0,0,1,2,6
4122,Keaton Miles,JR,2014-15,F,Arkansas,SEC,16,48,3,9,3,8,0,1,0,2,2,4,6,1,1,0,2,20,6
4123,Jaro Moravek,SO,2014-15,F,Troy,Sun Belt,3,26,2,7,0,0,2,7,0,0,3,3,6,1,0,0,2,2,6
4124,Mogboluwaga Oginni,JR,2014-15,F,Creighton,Big East,11,25,2,8,2,8,0,0,2,5,5,3,8,0,0,0,3,7,6
4125,Thomas Peters,SO,2014-15,F,Pacific,WCC,5,13,3,4,3,4,0,0,0,4,0,1,1,0,0,0,1,1,6
4126,Devon Pflueger,SO,2014-15,G,Southern California,Pac-12,7,16,2,6,0,4,2,2,0,0,3,4,7,0,0,0,0,5,6
4127,Nick Powell,FR,2014-15,G,North Carolina-Wilmington,CAA,8,13,2,6,0,0,2,6,0,0,0,1,1,0,0,0,0,1,6
4128,Jantzen Colie Raymond,FR,2014-15,G,Charleston Southern,Big South,7,27,2,7,2,5,0,2,2,2,0,3,3,1,0,0,2,3,6
4129,Demetre Rivers,SO,2014-15,G,Mercer,Southern,21,43,1,8,0,3,1,5,3,4,0,1,1,1,1,2,5,7,6
4130,Elijah Robertson,FR,2014-15,G-F,Chicago State,WAC,8,26,2,5,2,4,0,1,2,4,1,2,3,1,0,1,2,3,6
4131,Elbert Robinson,FR,2014-15,C,Louisiana State,SEC,11,68,3,7,3,7,0,0,0,2,6,11,17,5,5,3,9,13,6
4132,Dominic Romeo,SR,2014-15,F,Santa Clara,WCC,7,18,1,2,1,2,0,0,4,8,1,3,4,0,0,0,0,3,6
4133,Trey Slate,SO,2014-15,G,Oklahoma,Big 12,8,17,2,9,0,2,2,7,0,0,0,1,1,1,1,0,0,0,6
4134,James Stawarz,SR,2014-15,C,Illinois State,MVC,6,14,3,4,3,4,0,0,0,2,1,1,2,0,1,0,1,2,6
4135,Ford Stuen,JR,2014-15,G,Oklahoma State,Big 12,5,10,2,2,1,1,1,1,1,1,0,0,0,1,0,0,1,1,6
4136,Jacob Van,FR,2014-15,G,Air Force,MWC,7,20,2,5,1,2,1,3,1,2,1,3,4,2,1,0,1,0,6
4137,Paulius Vinogradovas,SR,2014-15,C,Norfolk State,MEAC,27,120,1,11,1,11,0,0,4,10,8,9,17,1,1,3,7,19,6
4138,Patrick Wallace,SO,2014-15,G,North Carolina State,ACC,5,11,2,8,1,2,1,6,1,2,1,1,2,1,0,0,1,0,6
4139,Tony Washington,FR,2014-15,F-C,La Salle,A-10,13,37,3,5,3,5,0,0,0,1,1,5,6,0,0,1,4,14,6
4140,Longi Yiljep,SR,2014-15,G,Brown,Ivy,7,34,2,7,2,6,0,1,2,2,1,4,5,0,1,3,3,7,6
4141,Yannick Atanga,SR,2014-15,F,Santa Clara,WCC,2,36,2,4,2,4,0,0,1,2,3,8,11,0,0,2,2,9,5
4142,Courtney Austin,JR,2014-15,G,Texas-Arlington,Sun Belt,13,33,2,3,1,1,1,2,0,0,0,2,2,1,0,0,1,6,5
4143,Anfernee Brown,SO,2014-15,G,Purdue,Big Ten,3,11,2,4,1,2,1,2,0,0,1,4,5,0,1,0,1,3,5
4144,Matt Brown,SR,2014-15,G,Harvard,Ivy,10,44,2,10,1,4,1,6,0,1,2,4,6,2,1,0,2,5,5
4145,Elliott Bullock,SR,2014-15,F-C,Stanford,Pac-12,10,34,2,4,1,3,1,1,0,0,1,2,3,0,0,0,0,6,5
4146,Langston Burnett,JR,2014-15,G,Wagner,NEC,8,93,2,14,2,3,0,11,1,4,3,6,9,2,0,4,6,6,5
4147,Jarvis Calhoun,FR,2014-15,G,Alabama-Birmingham,CUSA,11,56,2,16,1,5,1,11,0,1,0,2,2,4,0,0,3,1,5
4148,Zach Chu,SR,2014-15,G,Richmond,A-10,3,5,1,2,0,0,1,2,2,2,0,1,1,0,0,0,0,0,5
4149,Daniel Collie,JR,2014-15,G,Wright State,Horizon,10,85,2,7,1,3,1,4,0,0,1,4,5,6,5,0,3,12,5
4150,Drew Crabtree,SO,2014-15,G,Ohio,MAC,9,16,1,3,0,0,1,3,2,2,1,0,1,0,0,0,3,0,5
4151,Andrew Dakich,SO,2014-15,G,Michigan,Big Ten,13,69,2,8,1,5,1,3,0,0,0,4,4,2,1,0,3,11,5
4152,Anthony DeRiggs,SR,2014-15,G,Colgate,Patriot,5,10,2,4,1,1,1,3,0,0,0,1,1,0,0,0,0,0,5
4153,Mory Diane,FR,2014-15,G,Buffalo,MAC,4,31,2,3,1,1,1,2,0,3,0,4,4,2,0,0,3,3,5
4154,Dalton Dry,FR,2014-15,G,Texas Christian,Big 12,10,38,2,5,1,3,1,2,0,2,1,5,6,1,2,1,3,5,5
4155,Mohamed Farih,SR,2014-15,F,Saint Peter's,MAAC,6,9,2,3,2,3,0,0,1,2,0,1,1,0,0,0,3,2,5
4156,Denzel Flemings,JR,2014-15,F,Nicholls State,Southland,4,32,2,6,2,5,0,1,1,2,2,4,6,2,2,0,2,1,5
4157,Alek Frascone,FR,2014-15,G,Oakland,Horizon,10,23,2,4,1,3,1,1,0,0,0,2,2,1,0,0,4,2,5
4158,Theo Friedman,SO,2014-15,G,Oregon,Pac-12,5,20,2,5,1,3,1,2,0,0,1,3,4,3,0,0,0,1,5
4159,Vince Fritz,FR,2014-15,G,Sacred Heart,NEC,6,32,2,7,1,1,1,6,0,0,0,2,2,1,0,0,2,2,5
4160,Kyle Gonzalez,JR,2014-15,G,Radford,Big South,2,11,2,2,1,1,1,1,0,0,0,2,2,1,1,1,1,0,5
4161,Calvin Hoffman,FR,2014-15,G,Liberty,Big South,18,28,1,12,0,4,1,8,2,2,2,5,7,1,3,0,3,6,5
4162,Kourtlin Jackson,JR,2014-15,G,Iowa State,Big 12,8,26,2,4,2,2,0,2,1,2,2,3,5,0,1,0,1,3,5
4163,Caleb Johnston,FR,2014-15,G-F,Stephen F. Austin,Southland,18,31,2,3,2,2,0,1,1,2,0,2,2,1,0,0,2,4,5
4164,Kieffer Jordan,SO,2014-15,C,Army,Patriot,10,60,2,5,2,5,0,0,1,4,4,8,12,2,0,1,3,11,5
4165,Spencer Krannitz,JR,2014-15,G-F,Central Michigan,MAC,1,4,2,2,1,1,1,1,0,0,1,1,2,0,0,0,0,0,5
4166,Mike Lecak,JR,2014-15,G,Pittsburgh,ACC,9,20,1,5,0,2,1,3,2,2,0,4,4,0,0,0,0,5,5
4167,Eric Lockett,FR,2014-15,G,George Mason,A-10,5,30,1,4,1,4,0,0,3,5,1,1,2,2,1,1,3,4,5
4168,Evan Manning,JR,2014-15,G,Kansas,Big 12,9,27,2,5,1,2,1,3,0,0,0,2,2,2,3,0,1,3,5
4169,Mitch McCormick,JR,2014-15,G,Sam Houston State,Southland,14,45,1,10,0,1,1,9,2,2,1,2,3,1,1,0,1,3,5
4170,Jake McDowell,SO,2014-15,G-F,Memphis,AAC,10,24,2,8,1,6,1,2,0,0,0,4,4,1,2,0,2,5,5
4171,Raekwon Miller,FR,2014-15,G,North Carolina-Asheville,Big South,7,34,2,10,1,5,1,5,0,2,1,2,3,2,3,0,2,3,5
4172,Logan Mortenson,JR,2014-15,F,New Hampshire,AEC,2,16,2,5,2,4,0,1,1,2,1,2,3,0,1,0,0,1,5
4173,Anson Moye,SO,2014-15,G,Long Beach State,Big West,12,26,2,5,1,3,1,2,0,2,1,2,3,0,2,0,3,3,5
4174,Jake Newman,SO,2014-15,G,Lafayette,Patriot,13,35,1,1,1,1,0,0,3,8,1,5,6,2,0,0,0,2,5
4175,Casey Norris,JR,2014-15,G,Loyola Marymount,WCC,7,47,1,5,0,0,1,5,2,4,0,3,3,6,6,1,6,7,5
4176,Daniel Nwosu,SO,2014-15,G,Montana,Big Sky,17,44,2,7,1,2,1,5,0,0,2,1,3,1,1,0,3,9,5
4177,Stephen Osu,FR,2014-15,C,Presbyterian,Big South,10,19,1,4,1,4,0,0,3,6,3,1,4,1,0,0,1,2,5
4178,Andrew Papenfus,SR,2014-15,F,Santa Clara,WCC,3,10,1,5,0,1,1,4,2,2,1,2,3,1,4,0,0,1,5
4179,Trey Pettus,SO,2014-15,G,Butler,Big East,4,15,2,3,1,2,1,1,0,0,0,0,0,3,2,0,1,0,5
4180,Benquan Petty,JR,2014-15,G,Lamar,Southland,5,57,0,12,0,6,0,6,5,6,0,3,3,9,0,0,10,5,5
4181,Tom Planek,FR,2014-15,F,Providence,Big East,8,13,1,4,1,4,0,0,3,6,4,2,6,0,0,0,4,2,5
4182,Donald Ralls,FR,2014-15,G,Hampton,MEAC,9,17,2,6,1,1,1,5,0,0,0,1,1,1,0,0,2,2,5
4183,Jordan Rhodes,FR,2014-15,F-G,Massachusetts-Lowell,AEC,2,21,2,5,2,5,0,0,1,2,2,1,3,0,0,0,0,1,5
4184,Antwan Scott,SR,2014-15,G,Colorado State,MWC,4,33,2,7,1,2,1,5,0,0,0,2,2,6,0,0,3,4,5
4185,Tyler Simmons,FR,2014-15,G,Central Arkansas,Southland,10,14,2,5,1,3,1,2,0,0,0,1,1,0,0,0,2,1,5
4186,Xavier Smith,FR,2014-15,F,St. Bonaventure,A-10,12,59,2,7,2,6,0,1,1,3,4,11,15,1,1,8,1,5,5
4187,Jimmy Stamas,JR,2014-15,G,Milwaukee,Horizon,10,25,1,4,0,2,1,2,2,2,0,0,0,2,2,0,4,3,5
4188,Adam Sweeney,JR,2014-15,G,Gardner-Webb,Big South,7,21,2,7,1,4,1,3,0,0,0,2,2,3,0,0,2,2,5
4189,Ezra Talbert,FR,2014-15,F,Liberty,Big South,5,19,1,5,0,1,1,4,2,4,0,5,5,0,1,0,1,2,5
4190,Jacob Talbert,SO,2014-15,G,Campbell,Big South,3,9,1,4,1,2,0,2,3,4,2,3,5,1,0,0,1,0,5
4191,Trey Thompson,FR,2014-15,F,Arkansas,SEC,14,34,1,5,1,5,0,0,3,3,3,3,6,1,1,1,4,3,5
4192,Rob Vozenilek,SR,2014-15,G,Virginia,ACC,11,21,2,4,1,1,1,3,0,0,0,0,0,1,0,0,1,0,5
4193,Carrington Ward,JR,2014-15,G,North Texas,CUSA,4,30,2,4,2,3,0,1,1,2,0,4,4,2,0,0,4,6,5
4194,Joshua White,SO,2014-15,G,South Dakota State,Summit,2,7,2,5,1,4,1,1,0,0,1,2,3,1,1,1,1,1,5
4195,Ronnie White,JR,2014-15,F,Arkansas State,Sun Belt,3,26,1,4,1,4,0,0,3,4,2,8,10,0,0,0,1,4,5
4196,Shawn Wilborne,SO,2014-15,G,James Madison,CAA,3,6,2,3,1,1,1,2,0,0,1,0,1,0,0,0,1,0,5
4197,Samson Akilo,FR,2014-15,F,Manhattan,MAAC,8,18,2,3,2,3,0,0,0,0,2,2,4,0,0,0,3,10,4
4198,Hameed Ali,SR,2014-15,G,Texas A&amp;M-Corpus Christi,Southland,2,20,2,6,2,4,0,2,0,0,1,0,1,4,1,0,1,1,4
4199,Charlie Anastasi,SR,2014-15,F,Harvard,Ivy,9,20,1,4,1,4,0,0,2,2,2,2,4,1,0,1,0,1,4
4200,Kofi Andoh,SO,2014-15,G,Howard,MEAC,11,61,1,4,1,2,0,2,2,6,2,5,7,2,3,0,5,3,4
4201,Noah Arciero,FR,2014-15,G-F,Hartford,AEC,15,28,1,5,1,3,0,2,2,4,3,6,9,1,2,1,4,6,4
4202,Dillon Avare,FR,2014-15,G,Louisville,ACC,8,27,1,5,1,1,0,4,2,3,1,3,4,0,0,0,1,3,4
4203,Rem Bakamus,SO,2014-15,G,Gonzaga,WCC,8,16,1,3,1,1,0,2,2,4,0,2,2,1,1,0,0,4,4
4204,Maceo Baston,FR,2014-15,G-F,Florida Atlantic,CUSA,6,45,2,9,2,5,0,4,0,0,0,8,8,0,1,0,4,4,4
4205,Dekeba Battee-Aston,FR,2014-15,F,Fordham,A-10,26,109,1,11,1,9,0,2,2,3,3,12,15,3,2,1,8,19,4
4206,Thomas Blake,SO,2014-15,G,North Dakota,Big Sky,5,16,1,5,1,5,0,0,2,4,0,3,3,0,0,0,0,1,4
4207,Rob Blissitt,SO,2014-15,G,Cincinnati,AAC,5,7,1,2,0,1,1,1,1,2,0,0,0,1,0,0,1,0,4
4208,Wes Brewer,SO,2014-15,F,Elon,CAA,3,12,2,3,2,3,0,0,0,0,0,4,4,0,0,0,4,3,4
4209,Chris Brickhouse,SO,2014-15,F,North Carolina State,ACC,5,9,2,4,2,4,0,0,0,0,2,1,3,0,1,0,1,1,4
4210,Kyle Broekhuis,SO,2014-15,F,Air Force,MWC,9,31,1,5,1,4,0,1,2,4,2,7,9,3,2,0,3,4,4
4211,Aaron Brown,SR,2014-15,F,Mount St. Mary's,NEC,10,26,2,9,2,3,0,6,0,0,1,7,8,2,1,1,1,3,4
4212,Andre Brown,JR,2014-15,F,Arkansas-Little Rock,Sun Belt,12,78,2,6,2,6,0,0,0,1,8,5,13,0,3,0,4,9,4
4213,David Brown,SR,2014-15,G,UCLA,Pac-12,13,24,2,10,2,7,0,3,0,0,1,3,4,1,3,0,5,1,4
4214,Chase Cannon,JR,2014-15,G,North Carolina State,ACC,5,10,2,5,2,3,0,2,0,2,3,2,5,1,0,0,0,2,4
4215,C.J. Cole,SO,2014-15,F,Oklahoma,Big 12,14,38,2,5,2,5,0,0,0,3,1,6,7,1,0,0,3,9,4
4216,Gabriel Connealy,JR,2014-15,F,Creighton,Big East,10,22,0,7,0,4,0,3,4,4,4,2,6,0,1,0,1,2,4
4217,Adam Drexler,JR,2014-15,F,Houston,AAC,11,26,1,5,0,1,1,4,1,3,4,2,6,1,1,0,1,5,4
4218,Joe Ebondo,SR,2014-15,F,Old Dominion,CUSA,15,58,2,3,2,3,0,0,0,1,2,8,10,0,2,1,0,9,4
4219,Emmanuel Ezechinonso,JR,2014-15,C,Tulsa,AAC,13,37,1,2,1,2,0,0,2,2,1,7,8,0,0,0,3,8,4
4220,Desmond Fleming,SO,2014-15,G,Cornell,Ivy,12,26,1,2,1,2,0,0,2,3,0,1,1,5,1,0,1,7,4
4221,Matt Fraschilla,SO,2014-15,G,Harvard,Ivy,12,43,1,4,1,4,0,0,2,5,0,5,5,2,0,0,5,8,4
4222,Joshua Friar,FR,2014-15,F,Texas Southern,SWAC,9,56,2,4,2,4,0,0,0,2,3,5,8,2,0,2,2,10,4
4223,Alberto Ganis,SR,2014-15,F,Cal Poly,Big West,6,16,2,7,2,7,0,0,0,0,0,2,2,0,0,0,0,2,4
4224,Darrian Gray,SR,2014-15,G,Southeast Missouri State,OVC,3,20,2,8,2,4,0,4,0,2,1,1,2,2,0,0,0,2,4
4225,Matt Gregory,FR,2014-15,F,Notre Dame,ACC,11,21,1,3,1,3,0,0,2,4,1,2,3,0,0,0,1,0,4
4226,Abdoulaye Gueye,FR,2014-15,F,Georgia Tech,ACC,8,34,2,5,2,4,0,1,0,2,2,4,6,0,3,2,5,3,4
4227,Mike Harrell,SR,2014-15,G,Southern,SWAC,25,151,1,18,1,18,0,0,2,4,1,9,10,12,8,1,7,12,4
4228,James Herrick,FR,2014-15,C,Sacramento State,Big Sky,3,9,1,2,1,2,0,0,2,2,2,3,5,0,0,0,0,1,4
4229,Jalen Hyde,JR,2014-15,G,Rutgers,Big Ten,6,20,2,3,2,2,0,1,0,4,2,2,4,1,2,0,1,1,4
4230,Emeka Ikezu,SO,2014-15,F-C,Samford,Southern,10,30,2,3,2,3,0,0,0,2,2,1,3,0,0,0,4,12,4
4231,Dezmond James,FR,2014-15,G-F,Air Force,MWC,7,23,1,6,1,3,0,3,2,2,0,6,6,1,1,0,2,1,4
4232,Michael Johnson,SR,2014-15,F,Chicago State,WAC,12,58,2,9,2,8,0,1,0,0,7,15,22,3,1,1,1,13,4
4233,Jeff Jones,SO,2014-15,F,Virginia,ACC,8,13,2,4,2,4,0,0,0,0,3,1,4,0,1,0,0,3,4
4234,Cal Kennedy,FR,2014-15,F,Loyola (IL),MVC,7,8,2,3,2,2,0,1,0,0,1,1,2,0,0,1,0,1,4
4235,Charles Lockett,SR,2014-15,F,Long Beach State,Big West,11,21,1,5,1,5,0,0,2,4,1,2,3,0,0,0,3,1,4
4236,Sean Lonergan,SO,2014-15,F,Michigan,Big Ten,17,57,2,2,2,2,0,0,0,0,1,4,5,0,0,0,2,4,4
4237,Austin Mankin,SO,2014-15,F,Oklahoma,Big 12,17,65,1,9,1,6,0,3,2,2,0,6,6,2,1,0,1,4,4
4238,Jimmy Merrill,SO,2014-15,F,Siena,MAAC,7,15,2,3,2,2,0,1,0,0,1,1,2,0,1,0,0,1,4
4239,Aaron Moesch,FR,2014-15,F,Wisconsin,Big Ten,14,28,2,7,2,6,0,1,0,2,2,4,6,3,0,1,2,4,4
4240,Sebastian Norman,SR,2014-15,F,Lamar,Southland,10,47,0,5,0,4,0,1,4,4,4,3,7,0,2,1,1,5,4
4241,Tobe Okafor,JR,2014-15,C,Grand Canyon,WAC,5,41,2,10,2,10,0,0,0,0,1,4,5,0,0,3,3,9,4
4242,Edwin Olympio,FR,2014-15,G,Texas-San Antonio,CUSA,5,22,1,2,1,2,0,0,2,4,2,3,5,1,2,0,2,4,4
4243,Jordan Omogbehin,SR,2014-15,C,Morgan State,MEAC,10,30,2,5,2,5,0,0,0,4,5,3,8,1,1,2,3,9,4
4244,Sam Orchard,FR,2014-15,G,Utah State,MWC,9,53,2,9,2,6,0,3,0,3,4,5,9,7,3,0,4,7,4
4245,Christian Pino,FR,2014-15,G,Buffalo,MAC,11,14,1,3,1,3,0,0,2,4,0,0,0,1,0,0,2,2,4
4246,Matt Pollard,SO,2014-15,C,San Jose State,MWC,5,59,2,9,2,9,0,0,0,2,3,10,13,1,1,3,4,14,4
4247,Kevin Rafferty,SR,2014-15,F,Villanova,Big East,15,27,2,3,2,2,0,1,0,2,0,4,4,0,0,0,0,4,4
4248,Shawn Ray,JR,2014-15,F,California-Irvine,Big West,10,18,2,2,2,2,0,0,0,0,1,5,6,1,0,1,0,4,4
4249,Evan Richard,SR,2014-15,G,Milwaukee,Horizon,10,53,2,5,2,4,0,1,0,0,2,9,11,2,0,1,2,5,4
4250,Mike Robbins,SO,2014-15,G,Temple,AAC,8,11,1,3,0,1,1,2,1,2,1,2,3,2,1,0,1,1,4
4251,Daniel Robinson,SO,2014-15,F,Iona,MAAC,2,13,2,3,2,3,0,0,0,0,0,1,1,0,0,1,0,2,4
4252,Obi Romeo,FR,2014-15,F,Saint Joseph's,A-10,4,26,1,1,1,1,0,0,2,3,3,5,8,1,1,5,0,1,4
4253,Michael Saxton,JR,2014-15,G,Florida State,ACC,3,4,2,2,2,2,0,0,0,0,0,1,1,0,0,0,0,1,4
4254,Jon Schmidt,SR,2014-15,F,Brown,Ivy,5,18,2,4,2,4,0,0,0,1,1,4,5,0,0,2,1,1,4
4255,Darius Scott,JR,2014-15,F,Alabama State,SWAC,9,30,2,8,2,7,0,1,0,0,0,2,2,1,0,0,2,4,4
4256,Kyler Shula,JR,2014-15,G,Portland State,Big Sky,4,10,1,2,1,2,0,0,2,4,0,0,0,0,1,0,0,0,4
4257,Joshea Singleton,SR,2014-15,G,Bucknell,Patriot,3,11,1,3,0,1,1,2,1,2,0,0,0,0,0,0,0,2,4
4258,Matt Staubi,FR,2014-15,G,Loyola (MD),Patriot,10,16,2,3,2,3,0,0,0,0,0,2,2,0,1,0,2,3,4
4259,Matz Stockman,FR,2014-15,F-C,Louisville,ACC,4,22,2,5,2,5,0,0,0,2,2,9,11,1,2,4,3,6,4
4260,Niles Tate,FR,2014-15,G,Virginia Military Institute,Southern,4,12,2,5,2,2,0,3,0,0,2,0,2,1,0,0,0,3,4
4261,Reggie Theus,SO,2014-15,F,South Carolina,SEC,13,31,2,5,2,3,0,2,0,0,1,1,2,0,3,0,2,1,4
4262,Kaleb Warner,FR,2014-15,F,Pacific,WCC,6,25,2,5,2,3,0,2,0,0,3,2,5,7,0,0,0,0,4
4263,Mike Washington,JR,2014-15,G,Princeton,Ivy,10,21,2,5,2,3,0,2,0,3,0,3,3,4,1,0,1,3,4
4264,Aaron Williams,FR,2014-15,G,Western Carolina,Southern,6,7,1,1,1,1,0,0,2,2,0,2,2,0,0,1,3,0,4
4265,Matt Williams,JR,2014-15,G,Central Florida,AAC,1,9,0,3,0,0,0,3,4,4,0,1,1,0,0,1,0,1,4
4266,Mike Wilson,JR,2014-15,G,Siena,MAAC,7,17,2,4,2,3,0,1,0,0,0,3,3,0,1,0,0,1,4
4267,Tyler Winston,SO,2014-15,G,San Jose State,MWC,1,21,1,3,0,1,1,2,1,2,0,1,1,1,0,0,0,0,4
4268,Eric Youncofski,JR,2014-15,G,Rhode Island,A-10,6,6,1,3,1,3,0,0,2,2,0,0,0,0,0,0,0,2,4
4269,Tyler Ailshie,JR,2014-15,G,East Tennessee State,Southern,6,24,1,5,0,1,1,4,0,0,1,2,3,2,1,0,0,1,3
4270,Chier Ajou,JR,2014-15,C,Seton Hall,Big East,10,38,0,3,0,3,0,0,3,4,4,6,10,1,1,1,1,9,3
4271,Greg Alexander,SO,2014-15,G,East Carolina,AAC,6,14,1,4,1,2,0,2,1,3,0,0,0,1,0,1,1,2,3
4272,Kalen Alexander,SO,2014-15,G,Indiana State,MVC,6,8,1,3,0,2,1,1,0,0,1,1,2,1,0,0,0,0,3
4273,Kory Alford,JR,2014-15,G,UCLA,Pac-12,12,26,1,4,0,1,1,3,0,0,0,2,2,1,0,0,2,0,3
4274,Brandon Allums,JR,2014-15,F,Texas,Big 12,5,11,1,3,1,3,0,0,1,2,2,2,4,0,2,0,1,0,3
4275,Zach Altany,SR,2014-15,G,Georgia Southern,Sun Belt,6,14,1,11,0,3,1,8,0,0,0,2,2,0,1,0,1,0,3
4276,Jordan Anderson,FR,2014-15,G,Troy,Sun Belt,4,3,1,1,0,0,1,1,0,0,0,0,0,0,0,0,1,0,3
4277,Jeremy Bogus,SR,2014-15,G,Jacksonville,A-Sun,10,38,1,12,0,1,1,11,0,0,1,1,2,1,2,0,2,3,3
4278,Harrison Bowne,JR,2014-15,F,College of Charleston,CAA,3,6,1,2,0,1,1,1,0,0,0,1,1,1,0,0,0,0,3
4279,Jordan Brown,SO,2014-15,G,Weber State,Big Sky,4,19,1,2,0,0,1,2,0,0,0,2,2,0,0,0,0,4,3
4280,Kyle Brown,FR,2014-15,G,Cornell,Ivy,8,16,1,3,0,1,1,2,0,0,0,2,2,0,1,0,1,0,3
4281,Alex Budke,SR,2014-15,G,Oklahoma State,Big 12,6,11,1,2,0,1,1,1,0,0,1,3,4,1,1,0,2,2,3
4282,Justin Burks,FR,2014-15,F-G,California-Santa Barbara,Big West,2,16,1,2,0,0,1,2,0,0,0,0,0,0,0,0,1,0,3
4283,Carter Cagle,FR,2014-15,G,Georgia State,Sun Belt,12,16,1,2,0,0,1,2,0,0,0,1,1,1,1,0,1,2,3
4284,Jarryd Coleman,FR,2014-15,G,Charleston Southern,Big South,5,20,1,8,0,1,1,7,0,0,0,2,2,0,2,0,1,0,3
4285,Joe Coleman,JR,2014-15,G,Saint Mary's (CA),WCC,1,14,1,3,0,0,1,3,0,0,0,1,1,0,0,0,2,1,3
4286,Chris Collins,FR,2014-15,G,Texas A&amp;M,SEC,3,5,1,1,0,0,1,1,0,0,0,0,0,0,0,0,0,2,3
4287,Patrick Conroy,SO,2014-15,G,Nevada,MWC,7,16,1,5,1,1,0,4,1,2,0,1,1,4,0,0,2,0,3
4288,Eddie Davis,FR,2014-15,F,Southern Mississippi,CUSA,4,19,1,5,0,2,1,3,0,0,1,4,5,0,0,1,1,5,3
4289,Simeon Dennis,JR,2014-15,G-F,Saint Peter's,MAAC,6,19,1,4,0,0,1,4,0,0,0,1,1,0,1,1,1,2,3
4290,Ryan Dickey,SO,2014-15,G,Samford,Southern,4,10,1,5,0,1,1,4,0,0,0,1,1,1,0,0,0,1,3
4291,Cory Dolins,JR,2014-15,G,DePaul,Big East,9,10,1,2,1,2,0,0,1,2,1,1,2,1,0,0,1,2,3
4292,Brandon Eddlestone,SO,2014-15,F,Louisiana State,SEC,3,9,1,2,0,1,1,1,0,0,0,1,1,0,1,0,1,1,3
4293,Eyimofe Edukugho,JR,2014-15,F,Sacred Heart,NEC,3,16,0,5,0,5,0,0,3,6,2,1,3,1,0,2,1,2,3
4294,Patrick Farrell,JR,2014-15,F,Villanova,Big East,15,27,1,5,0,0,1,5,0,0,0,3,3,1,2,0,3,1,3
4295,Tyler Flores,FR,2014-15,G,Texas-San Antonio,CUSA,4,9,1,3,0,0,1,3,0,0,0,0,0,0,0,0,0,0,3
4296,Jackson Forbes,FR,2014-15,F,Princeton,Ivy,3,12,1,2,0,0,1,2,0,0,0,2,2,1,0,0,1,0,3
4297,Manu Giamoukis,SO,2014-15,G,Davidson,A-10,11,17,1,4,0,1,1,3,0,0,1,0,1,1,0,0,0,2,3
4298,Colten Gober,FR,2014-15,G,Texas-Arlington,Sun Belt,3,11,1,2,0,0,1,2,0,0,1,0,1,0,0,0,1,0,3
4299,Aric Gresko,JR,2014-15,G,Saint Francis (PA),NEC,6,17,1,4,0,0,1,4,0,0,2,2,4,2,1,0,3,0,3
4300,Jacob Gross,FR,2014-15,G,North Texas,CUSA,8,9,1,1,0,0,1,1,0,0,1,1,2,0,0,0,0,0,3
4301,Amari Hamilton,FR,2014-15,G,North Carolina A&amp;T,MEAC,10,25,0,6,0,1,0,5,3,6,0,1,1,3,0,0,2,2,3
4302,Jake Hammond,FR,2014-15,F,Nebraska,Big Ten,11,36,1,5,1,5,0,0,1,3,3,4,7,1,0,2,2,6,3
4303,David Hanson,JR,2014-15,G,Abilene Christian,Southland,13,35,1,6,0,3,1,3,0,2,1,3,4,5,1,1,2,4,3
4304,Daniel Harper,SO,2014-15,G,Oklahoma,Big 12,6,11,1,2,0,0,1,2,0,0,1,1,2,1,0,0,0,0,3
4305,Eli Harrison,SO,2014-15,F,Dartmouth,Ivy,3,7,1,1,0,0,1,1,0,0,0,1,1,0,0,0,0,2,3
4306,John Heard,JR,2014-15,F,Baylor,Big 12,7,15,1,4,0,0,1,4,0,0,0,4,4,0,0,0,0,2,3
4307,Ricardo Hill,FR,2014-15,G,Akron,MAC,8,18,1,4,1,2,0,2,1,2,1,2,3,0,2,0,0,0,3
4308,Jaran Hoover,FR,2014-15,G,Northern Arizona,Big Sky,3,6,1,4,0,0,1,4,0,0,0,0,0,0,0,0,0,2,3
4309,Maalik Howard,SO,2014-15,G,Mount St. Mary's,NEC,9,19,1,2,0,1,1,1,0,0,1,1,2,1,0,0,0,1,3
4310,Tyrone Hughes,JR,2014-15,G,West Virginia,Big 12,7,14,1,4,0,0,1,4,0,2,0,1,1,3,0,0,1,1,3
4311,David Irby,SO,2014-15,G,San Francisco,WCC,4,6,1,1,0,0,1,1,0,0,0,0,0,0,0,0,0,0,3
4312,Cole Israelson,FR,2014-15,C,Central Michigan,MAC,5,10,1,6,1,6,0,0,1,2,0,1,1,0,0,2,0,1,3
4313,Dexter Jenkins,JR,2014-15,G,Western Carolina,Southern,3,4,1,3,1,2,0,1,1,2,1,1,2,1,0,0,1,1,3
4314,Patrick Keim,FR,2014-15,G,Auburn,SEC,8,8,1,4,0,0,1,4,0,2,0,2,2,3,0,0,1,0,3
4315,Scott Kelly,SO,2014-15,F,Georgia Southern,Sun Belt,5,14,1,1,1,1,0,0,1,2,2,4,6,1,0,0,2,1,3
4316,Patrick Kerrigan,SR,2014-15,F,Holy Cross,Patriot,6,9,1,1,0,0,1,1,0,0,0,2,2,0,0,0,0,1,3
4317,Joel King,SR,2014-15,G,Portland State,Big Sky,3,7,1,2,1,2,0,0,1,1,0,0,0,1,0,0,1,1,3
4318,Joshua Ko,SO,2014-15,G,Pittsburgh,ACC,5,6,1,4,0,2,1,2,0,0,0,1,1,0,0,1,0,1,3
4319,Matt Kourouma,JR,2014-15,G-F,North Dakota State,Summit,4,5,1,3,1,3,0,0,1,2,0,0,0,0,0,0,0,0,3
4320,Tod Lanter,SR,2014-15,G,Kentucky,SEC,7,8,1,1,0,0,1,1,0,0,0,0,0,0,0,0,0,0,3
4321,O.J. Lewis,JR,2014-15,G,La Salle,A-10,6,7,1,2,1,2,0,0,1,2,0,0,0,0,1,0,1,1,3
4322,Henry Lowe,JR,2014-15,G,Villanova,Big East,16,33,1,7,0,1,1,6,0,0,0,2,2,1,1,0,0,3,3
4323,Trey Mason,SO,2014-15,G,Arizona,Pac-12,9,12,1,3,0,2,1,1,0,0,0,1,1,0,0,0,1,0,3
4324,Blake McBride,FR,2014-15,G,Bryant,NEC,10,31,1,7,0,3,1,4,0,0,1,2,3,1,0,1,0,5,3
4325,Ryan McClurg,SO,2014-15,F,Texas,Big 12,4,9,1,3,1,3,0,0,1,2,2,0,2,1,0,0,2,1,3
4326,Jimmy McDonnell,SR,2014-15,F,Temple,AAC,15,52,1,9,0,7,1,2,0,1,4,4,8,2,2,3,5,8,3
4327,Sharieff Medlock,FR,2014-15,G,Chicago State,WAC,4,9,1,1,0,0,1,1,0,0,0,1,1,0,2,0,0,0,3
4328,Trevor Menke,SR,2014-15,G,Nebraska,Big Ten,7,13,1,2,0,0,1,2,0,0,0,0,0,0,0,0,0,1,3
4329,Edon Molic,JR,2014-15,G,St. Francis (NY),NEC,6,7,1,5,0,0,1,5,0,0,0,0,0,0,0,0,1,2,3
4330,Jean-Micheal Mudiay,SR,2014-15,G,Southern Methodist,AAC,6,15,0,5,0,2,0,3,3,7,0,1,1,0,0,0,3,1,3
4331,Tarale Murry,SR,2014-15,G,Texas,Big 12,5,8,1,8,1,3,0,5,1,4,1,2,3,0,0,0,0,1,3
4332,Chima Nwakpuda,JR,2014-15,F,Temple,AAC,7,8,1,1,1,1,0,0,1,2,0,2,2,0,0,0,1,0,3
4333,Mudiaga Okagbare,JR,2014-15,F,Mississippi Valley State,SWAC,1,25,1,3,1,3,0,0,1,3,0,4,4,0,1,0,3,0,3
4334,Nick Pagliuca,SO,2014-15,G,Duke,ACC,11,18,1,5,0,1,1,4,0,0,2,2,4,1,0,0,0,4,3
4335,Stelios Papafloratos,FR,2014-15,G,Nevada,MWC,9,24,1,9,0,2,1,7,0,2,0,3,3,1,0,0,4,3,3
4336,Cameron Pappas,JR,2014-15,G,Charlotte,CUSA,4,5,0,3,0,1,0,2,3,4,1,2,3,2,0,0,0,1,3
4337,Mark Patterson,FR,2014-15,G,Cal Poly,Big West,2,12,1,7,0,4,1,3,0,0,0,3,3,0,0,0,0,1,3
4338,Casey Perrin,JR,2014-15,G,Campbell,Big South,3,15,1,3,0,1,1,2,0,0,0,0,0,4,1,0,0,4,3
4339,Eric Porter,FR,2014-15,G,Loyola (IL),MVC,4,7,1,1,0,0,1,1,0,0,0,1,1,0,0,0,1,0,3
4340,Eric Rippetoe,SR,2014-15,F,Southern Utah,Big Sky,2,10,1,4,1,2,0,2,1,2,1,0,1,0,0,0,0,0,3
4341,Richard Romeo,JR,2014-15,G,West Virginia,Big 12,7,12,1,3,0,0,1,3,0,0,0,2,2,2,0,0,0,2,3
4342,Charlie Rose,FR,2014-15,G,Iowa,Big Ten,8,16,1,1,0,0,1,1,0,0,0,0,0,1,0,0,1,0,3
4343,Patrick Ryan,SO,2014-15,G,Elon,CAA,3,10,1,4,1,1,0,3,1,2,2,4,6,2,0,0,2,1,3
4344,Carter Sanderson,SR,2014-15,G,Syracuse,ACC,4,4,1,4,0,0,1,4,0,0,0,1,1,0,0,0,0,0,3
4345,Joe Schwartz,SR,2014-15,G,Texas,Big 12,1,2,1,1,0,0,1,1,0,0,0,0,0,0,0,0,0,0,3
4346,Martin Shaw,JR,2014-15,G,Old Dominion,CUSA,11,17,1,9,1,9,0,0,1,2,0,0,0,1,0,1,1,0,3
4347,Henry Shortess,SO,2014-15,G,Louisiana State,SEC,3,6,1,1,0,0,1,1,0,0,0,0,0,0,0,0,0,0,3
4348,Marek Soucek,SR,2014-15,F-C,Oklahoma State,Big 12,7,18,1,3,0,1,1,2,0,0,0,1,1,0,0,0,1,2,3
4349,Trey Stacey,FR,2014-15,G,Wright State,Horizon,6,7,1,2,0,0,1,2,0,0,0,0,0,0,0,0,1,1,3
4350,Justin Stangel,JR,2014-15,C,Oregon State,Pac-12,10,30,1,2,1,2,0,0,1,2,1,3,4,0,0,1,3,10,3
4351,Alex Stecca,SO,2014-15,F,Northern Arizona,Big Sky,4,11,1,1,1,1,0,0,1,2,4,1,5,1,1,0,0,2,3
4352,Cole Stockton,JR,2014-15,G,Auburn,SEC,12,21,1,6,0,0,1,6,0,0,1,1,2,0,0,0,1,3,3
4353,Kyle Thompson,FR,2014-15,G,Saint Joseph's,A-10,4,8,1,2,1,2,0,0,1,2,1,1,2,1,0,0,0,0,3
4354,Zack Tobler,SO,2014-15,F,Cincinnati,AAC,8,11,1,5,1,3,0,2,1,5,0,1,1,0,0,0,1,2,3
4355,Frank Toohey,FR,2014-15,C,Air Force,MWC,6,18,1,2,1,2,0,0,1,6,2,5,7,1,0,0,0,3,3
4356,Sean Tuohy,SO,2014-15,G,Loyola (MD),Patriot,11,33,1,7,0,2,1,5,0,1,1,2,3,1,0,0,1,2,3
4357,Max Twyman,FR,2014-15,G,Albany (NY),AEC,8,9,1,3,0,0,1,3,0,0,0,1,1,0,0,0,0,1,3
4358,Jidbay Ugbaja,FR,2014-15,G,Sacramento State,Big Sky,5,8,1,4,1,1,0,3,1,1,0,2,2,1,0,0,2,2,3
4359,David Urso,FR,2014-15,G,Vermont,AEC,9,31,1,6,0,2,1,4,0,2,0,8,8,2,0,0,2,2,3
4360,Trent VanHorn,SO,2014-15,G,Wake Forest,ACC,5,26,1,6,1,4,0,2,1,2,0,2,2,0,1,0,2,6,3
4361,Nick Victor,JR,2014-15,G,Yale,Ivy,6,42,1,6,1,3,0,3,1,4,3,11,14,8,2,3,4,3,3
4362,Daniel Wallace,FR,2014-15,C-F,Saint Francis (PA),NEC,6,17,1,3,1,3,0,0,1,2,0,3,3,0,0,1,3,3,3
4363,Peter Westra,SR,2014-15,G,Maine,AEC,1,3,1,2,1,1,0,1,1,2,0,0,0,0,0,0,0,2,3
4364,Keenan Wetzel,SR,2014-15,G,Michigan State,Big Ten,14,31,1,9,0,2,1,7,0,0,1,3,4,0,0,0,1,2,3
4365,Christian White,JR,2014-15,G,Syracuse,ACC,4,7,1,2,0,0,1,2,0,2,1,2,3,0,0,0,1,0,3
4366,Dominique Williams,SO,2014-15,G,San Francisco,WCC,4,7,1,3,0,1,1,2,0,0,0,1,1,1,0,0,1,1,3
4367,Jermaine Williams,SR,2014-15,G,South Alabama,Sun Belt,8,14,1,3,1,1,0,2,1,1,0,1,1,0,2,0,0,1,3
4368,Matt Williams,JR,2014-15,G,Davidson,A-10,11,21,1,2,1,2,0,0,1,2,2,3,5,1,0,0,3,5,3
4369,Gavin Wilson,JR,2014-15,G,Charlotte,CUSA,5,5,1,6,0,1,1,5,0,0,0,2,2,0,0,0,1,1,3
4370,Austin Witherill,FR,2014-15,G,Arizona State,Pac-12,3,5,1,3,0,1,1,2,0,0,1,2,3,0,0,0,0,1,3
4371,Casey Woodring,SO,2014-15,G,Providence,Big East,7,12,1,7,0,2,1,5,0,0,1,0,1,0,0,0,0,1,3
4372,Jared Young,SR,2014-15,G,Arkansas-Pine Bluff,SWAC,4,6,1,1,0,0,1,1,0,0,0,0,0,0,0,0,2,1,3
4373,Kristopher Acevedo,JR,2014-15,G,California-Riverside,Big West,2,6,1,3,1,2,0,1,0,0,0,1,1,0,0,0,0,2,2
4374,Tyler Adams,SR,2014-15,C,Georgetown,Big East,1,0,1,1,1,1,0,0,0,0,,,0,0,,,,,2
4375,TeJai Allen,SO,2014-15,G,Florida Gulf Coast,A-Sun,7,7,0,0,0,0,0,0,2,2,1,0,1,0,1,0,1,0,2
4376,Keith Armstrong,JR,2014-15,F,East Carolina,AAC,11,36,1,4,1,4,0,0,0,0,2,4,6,1,0,1,2,5,2
4377,Reid Aube,SO,2014-15,F,Charlotte,CUSA,4,5,1,2,1,2,0,0,0,0,2,3,5,0,0,0,0,2,2
4378,Matt Banas,JR,2014-15,F,Bucknell,Patriot,7,14,1,1,1,1,0,0,0,0,1,0,1,1,0,0,0,2,2
4379,K.J. Bates,SO,2014-15,G,Chattanooga,Southern,6,24,1,6,1,4,0,2,0,0,0,6,6,2,2,0,3,2,2
4380,David Bloom,FR,2014-15,G,Texas A&amp;M-Corpus Christi,Southland,2,6,0,3,0,3,0,0,2,6,2,1,3,0,0,0,0,0,2
4381,Trevor Bohnhoff,JR,2014-15,F,Michigan State,Big Ten,13,23,0,0,0,0,0,0,2,4,1,2,3,0,1,0,0,0,2
4382,Greg Bowman,FR,2014-15,F,Washington,Pac-12,6,11,1,2,1,1,0,1,0,0,1,1,2,1,0,0,0,1,2
4383,Tim Brennan,SR,2014-15,G-F,Western Michigan,MAC,6,21,0,4,0,1,0,3,2,5,1,2,3,1,4,0,1,3,2
4384,Richard Brown,FR,2014-15,G,Army,Patriot,11,56,1,4,1,2,0,2,0,0,5,6,11,4,1,0,2,4,2
4385,Grant Bryant,FR,2014-15,F,East Carolina,AAC,3,12,1,2,1,2,0,0,0,0,0,2,2,0,0,0,3,0,2
4386,Kyle Buffkin,SO,2014-15,C,Coastal Carolina,Big South,11,51,0,9,0,9,0,0,2,6,6,4,10,1,1,1,5,14,2
4387,Mike Burnett,JR,2014-15,G,Colorado State,MWC,4,10,1,2,1,2,0,0,0,0,0,0,0,0,0,0,1,3,2
4388,Emerson Bursis,SR,2014-15,F,Rider,MAAC,7,13,1,4,1,2,0,2,0,0,0,2,2,0,0,0,1,2,2
4389,Brandon Busuttil,JR,2014-15,G,Bowling Green State,MAC,9,19,1,3,1,1,0,2,0,0,0,1,1,1,0,0,1,1,2
4390,Dalton Cesarz,SO,2014-15,G,Saint Francis (PA),NEC,3,6,1,1,1,1,0,0,0,0,0,0,0,1,0,0,0,1,2
4391,Ian Chiles,SR,2014-15,G,Tennessee,SEC,3,14,1,2,1,1,0,1,0,0,0,2,2,1,1,0,0,1,2
4392,Kevin Coker,JR,2014-15,F,Xavier,Big East,3,4,1,1,1,1,0,0,0,0,0,0,0,0,0,0,0,0,2
4393,Chris Corchiani,FR,2014-15,G,North Carolina State,ACC,5,10,1,4,1,2,0,2,0,0,0,1,1,1,1,0,1,2,2
4394,George Davis,SO,2014-15,G,Central Connecticut State,NEC,7,9,1,2,1,1,0,1,0,0,0,2,2,1,,1,2,1,2
4395,Hank Davis,SO,2014-15,G,La Salle,A-10,5,6,1,1,1,1,0,0,0,0,0,0,0,2,1,0,0,3,2
4396,Mike DeLorenzo,SR,2014-15,G,Monmouth,MAAC,11,10,1,3,1,3,0,0,0,0,0,0,0,0,1,0,1,0,2
4397,Terrance Ditimi,SR,2014-15,F,Connecticut,AAC,6,7,1,1,1,1,0,0,0,0,0,1,1,0,0,0,0,1,2
4398,Kyle Dobbins,SO,2014-15,G,Texas A&amp;M,SEC,6,9,1,3,1,2,0,1,0,0,0,0,0,2,0,0,2,1,2
4399,Sam Donahue,SO,2014-15,G,Boston College,ACC,7,8,1,2,1,1,0,1,0,0,0,0,0,0,0,0,0,0,2
4400,Gabriel Dos Santos,JR,2014-15,G,Jacksonville State,OVC,2,9,1,2,1,2,0,0,0,1,0,1,1,2,0,0,2,0,2
4401,Tre Duncan,SR,2014-15,G,High Point,Big South,7,14,1,1,1,1,0,0,0,0,0,0,0,1,0,0,1,2,2
4402,Ede Egharevba,SR,2014-15,F,Albany (NY),AEC,5,8,1,5,1,3,0,2,0,1,0,1,1,0,2,0,1,3,2
4403,Jordan Ellis,JR,2014-15,G,Brigham Young,WCC,16,41,1,2,1,2,0,0,0,2,0,5,5,3,1,0,2,4,2
4404,Mike Fernandez,SO,2014-15,G,Miami (FL),ACC,4,6,1,2,1,1,0,1,0,0,0,0,0,0,0,0,0,1,2
4405,Matt Ferris,FR,2014-15,G,Wisconsin,Big Ten,9,17,1,3,1,2,0,1,0,0,3,2,5,0,1,1,1,1,2
4406,Khyler Fields,JR,2014-15,G,Cleveland State,Horizon,2,6,1,1,1,1,0,0,0,0,0,1,1,0,0,0,2,1,2
4407,Khwan Fore,FR,2014-15,G,Richmond,A-10,2,15,1,3,1,2,0,1,0,0,0,1,1,1,1,0,2,1,2
4408,Nick Foschia,JR,2014-15,F,Duquesne,A-10,10,18,1,4,1,2,0,2,0,2,1,2,3,0,0,0,1,1,2
4409,Sam Frayer,FR,2014-15,F,Ohio,MAC,8,11,1,2,1,1,0,1,0,0,0,5,5,0,0,1,1,1,2
4410,Maleek Frazier,SR,2014-15,G,Virginia,ACC,10,17,1,2,1,2,0,0,0,1,0,4,4,0,0,0,2,0,2
4411,Geoffrey Frid,SO,2014-15,C,Northern Arizona,Big Sky,11,33,1,1,1,1,0,0,0,0,0,4,4,1,2,0,0,11,2
4412,Bobby Garbade,SR,2014-15,C,Princeton,Ivy,16,52,1,9,1,9,0,0,0,0,1,5,6,8,0,0,3,6,2
4413,Malik Garner,JR,2014-15,F,Maryland-Baltimore County,AEC,6,24,1,4,1,3,0,1,0,0,1,1,2,1,0,0,0,3,2
4414,Christian Garrett,SR,2014-15,G,Kansas,Big 12,9,14,1,5,1,4,0,1,0,0,1,1,2,1,0,0,3,2,2
4415,John Gibson,SO,2014-15,F,Alabama,SEC,3,5,1,1,1,1,0,0,0,1,1,2,3,0,1,0,0,2,2
4416,Dylan Greene,JR,2014-15,G,Lipscomb,A-Sun,8,21,0,2,0,0,0,2,2,4,1,1,2,2,0,0,1,3,2
4417,Paxson Guest,JR,2014-15,F,Northwestern State,Southland,11,13,1,4,1,1,0,3,0,0,1,0,1,0,0,0,2,2,2
4418,Erando Halilaj,SR,2014-15,F,Fordham,A-10,5,7,1,2,1,2,0,0,0,0,1,0,1,1,0,0,1,0,2
4419,Nick Hamilton,FR,2014-15,G,California,Pac-12,5,10,1,4,1,4,0,0,0,0,1,0,1,0,1,0,0,1,2
4420,Matt Hanessian,SR,2014-15,G-F,Pennsylvania,Ivy,6,18,1,2,1,2,0,0,0,0,2,3,5,0,0,0,5,4,2
4421,David Haus,FR,2014-15,G,Duquesne,A-10,11,28,1,4,1,3,0,1,0,0,4,1,5,2,0,0,0,3,2
4422,Harrison Hawks,FR,2014-15,G,Tennessee-Martin,OVC,5,14,1,5,1,3,0,2,0,0,0,0,0,3,0,0,1,0,2
4423,Jacob Hazzard,JR,2014-15,G,Arizona,Pac-12,17,27,1,10,1,4,0,6,0,0,0,0,0,1,0,0,5,1,2
4424,Brian Herring,FR,2014-15,G,Texas State,Sun Belt,5,14,1,6,1,2,0,4,0,1,0,0,0,1,1,0,0,1,2
4425,C.J. Hill,FR,2014-15,G,Northeastern,CAA,10,15,0,4,0,3,0,1,2,2,0,1,1,0,0,0,6,4,2
4426,Grant Hollander,FR,2014-15,G,Saint Louis,A-10,1,1,1,2,1,2,0,0,0,0,1,0,1,0,0,0,0,0,2
4427,John Hubler,FR,2014-15,G,IUPUI,Summit,8,22,0,5,0,1,0,4,2,2,0,0,0,0,0,0,3,2,2
4428,Connor Jean,JR,2014-15,G,Loyola Marymount,WCC,2,16,1,1,1,1,0,0,0,0,0,1,1,0,0,0,0,4,2
4429,Conrad Jenne,FR,2014-15,G,Virginia Military Institute,Southern,1,9,1,5,1,1,0,4,0,2,0,1,1,0,2,0,0,1,2
4430,Tyler Johnson,SR,2014-15,F,William &amp; Mary,CAA,5,17,1,5,1,5,0,0,0,0,0,4,4,0,0,1,0,2,2
4431,Christian Johnston,JR,2014-15,G,Duquesne,A-10,8,13,1,7,1,6,0,1,0,0,1,1,2,0,1,0,1,1,2
4432,Isaiah Juarez,FR,2014-15,G,Grand Canyon,WAC,6,7,1,2,1,1,0,1,0,0,0,1,1,1,0,0,0,0,2
4433,Caid Kirven,JR,2014-15,F,Virginia,ACC,10,18,1,2,1,2,0,0,0,0,2,2,4,0,0,0,1,1,2
4434,Kye Kurkowski,SR,2014-15,C,Nebraska,Big Ten,7,12,1,2,1,2,0,0,0,0,2,1,3,0,0,0,1,0,2
4435,Nic Lane,SR,2014-15,G,Colgate,Patriot,5,7,1,1,1,1,0,0,0,0,0,1,1,1,0,0,1,0,2
4436,Montie Leunen,FR,2014-15,F,Portland State,Big Sky,5,19,0,3,0,0,0,3,2,2,0,3,3,1,0,0,1,1,2
4437,Micah Littlejohn,FR,2014-15,G,Tulsa,AAC,4,6,1,2,1,1,0,1,0,0,0,1,1,0,0,0,0,0,2
4438,Miki Ljuboja,FR,2014-15,F,Brown,Ivy,5,16,1,2,1,1,0,1,0,0,1,1,2,0,2,0,4,2,2
4439,KJ Logue,JR,2014-15,F,Cal Poly,Big West,9,48,0,1,0,1,0,0,2,6,4,2,6,1,1,0,1,2,2
4440,Michael Mache,JR,2014-15,F,Marquette,Big East,4,6,1,2,1,2,0,0,0,0,2,0,2,0,0,0,0,0,2
4441,Marshall Macheledt,FR,2014-15,F,Duquesne,A-10,6,10,1,2,1,2,0,0,0,0,1,2,3,0,0,1,0,1,2
4442,Gerrald Maddox,SO,2014-15,G,Jackson State,SWAC,7,24,1,9,1,6,0,3,0,0,2,2,4,2,2,0,1,3,2
4443,Max Martino,SR,2014-15,G,Northern Iowa,MVC,16,34,0,7,0,3,0,4,2,3,1,2,3,1,0,0,0,4,2
4444,Tyrell Mason,SO,2014-15,G,Virginia Military Institute,Southern,7,27,1,6,1,4,0,2,0,0,5,6,11,1,2,0,2,4,2
4445,Marius McAllister,FR,2014-15,G,North Carolina Central,MEAC,5,9,1,1,1,1,0,0,0,0,0,3,3,1,0,0,0,1,2
4446,John McCarty,FR,2014-15,F,Central Michigan,MAC,1,4,1,1,1,1,0,0,0,0,2,0,2,1,0,0,0,1,2
4447,Ty'Shaun McCollum,SO,2014-15,F,North Carolina A&amp;T,MEAC,6,6,1,1,1,1,0,0,0,0,0,0,0,0,0,0,0,0,2
4448,Riley McGillan,JR,2014-15,G,Clemson,ACC,8,12,1,5,1,1,0,4,0,0,1,1,2,0,1,0,0,1,2
4449,David Molinari,JR,2014-15,G,DePaul,Big East,10,14,1,5,1,2,0,3,0,0,0,1,1,2,1,0,0,0,2
4450,Wade Morgan,SR,2014-15,G,Stanford,Pac-12,8,14,1,5,1,3,0,2,0,0,1,4,5,2,1,0,1,1,2
4451,Patrick Myers,JR,2014-15,G,South Carolina State,MEAC,5,21,1,3,1,1,0,2,0,0,0,5,5,1,1,1,2,2,2
4452,Chris Nealey,FR,2014-15,G,Boise State,MWC,7,19,0,1,0,0,0,1,2,2,0,1,1,1,3,0,1,3,2
4453,Danny Newsome,SO,2014-15,F,Texas,Big 12,5,13,1,4,1,3,0,1,0,0,1,4,5,0,0,0,1,3,2
4454,Cameron Neysmith,SO,2014-15,G,Kennesaw State,A-Sun,6,10,1,3,1,2,0,1,0,0,1,2,3,0,0,0,0,2,2
4455,Stephen O'Suji,FR,2014-15,G,Houston Baptist,Southland,9,26,0,4,0,3,0,1,2,5,3,1,4,6,3,0,1,2,2
4456,Ifeanyi Onyekaba,JR,2014-15,C,Rhode Island,A-10,7,38,0,3,0,3,0,0,2,4,2,6,8,0,1,1,1,13,2
4457,Trevor Osborn,SO,2014-15,G,IPFW,Summit,5,10,1,4,1,1,0,3,0,1,0,0,0,0,1,0,1,0,2
4458,Nick Pendergast,SR,2014-15,F,Temple,AAC,12,20,1,6,1,4,0,2,0,2,1,0,1,1,0,1,1,3,2
4459,Steve Perpiglia,JR,2014-15,G,Boston College,ACC,17,29,1,2,1,1,0,1,0,0,0,0,0,5,2,0,3,2,2
4460,Joaquin Pistokache,SO,2014-15,G,Texas-Pan American,WAC,7,20,1,2,1,2,0,0,0,0,0,1,1,0,2,0,1,3,2
4461,Simon Pittman,FR,2014-15,G,Saint Francis (PA),NEC,3,6,0,0,0,0,0,0,2,4,1,2,3,0,0,0,2,1,2
4462,Mark Plousis,SR,2014-15,G-F,Hartford,AEC,5,7,0,0,0,0,0,0,2,4,0,2,2,0,0,0,1,1,2
4463,Josh Pollard,FR,2014-15,G,Kansas,Big 12,7,13,1,4,1,4,0,0,0,0,1,1,2,1,1,0,1,2,2
4464,Freddy Poole,FR,2014-15,F,Winthrop,Big South,8,14,1,1,1,1,0,0,0,0,1,5,6,0,1,0,3,2,2
4465,Stephen Prendergast,JR,2014-15,G,Wake Forest,ACC,4,9,1,3,1,2,0,1,0,0,0,0,0,0,0,0,1,2,2
4466,Tim Priller,FR,2014-15,F,Indiana,Big Ten,8,23,1,6,1,3,0,3,0,0,1,2,3,0,1,2,2,5,2
4467,Rusty Reigel,FR,2014-15,G,Davidson,A-10,12,26,1,5,1,2,0,3,0,0,1,2,3,2,0,0,2,3,2
4468,Tyson Reynold,JR,2014-15,F,Western Illinois,Summit,5,14,1,5,1,5,0,0,0,0,2,4,6,1,0,0,2,2,2
4469,Nate Ritchie,FR,2014-15,F,Indiana,Big Ten,6,15,0,1,0,1,0,0,2,2,3,3,6,2,1,0,0,1,2
4470,Peyton Robbins,JR,2014-15,G,East Carolina,AAC,1,1,1,2,1,2,0,0,0,0,0,0,0,0,1,0,0,0,2
4471,Stanley Roberts,FR,2014-15,F,Tulane,AAC,2,6,1,1,1,1,0,0,0,0,0,1,1,0,0,1,0,2,2
4472,Brian Rohleder,JR,2014-15,G,Kansas State,Big 12,17,65,1,5,1,2,0,3,0,2,2,4,6,5,3,1,3,14,2
4473,Michael Rudy,JR,2014-15,F,George Mason,A-10,4,4,1,1,1,1,0,0,0,0,0,0,0,0,0,0,0,1,2
4474,Hunter Sadlon,SO,2014-15,G,Winthrop,Big South,11,31,0,0,0,0,0,0,2,4,0,3,3,2,0,0,2,4,2
4475,Nick Segura,FR,2014-15,F,Northwestern,Big Ten,2,3,0,2,0,1,0,1,2,2,2,0,2,0,0,0,0,1,2
4476,Tyler Self,SO,2014-15,G,Kansas,Big 12,7,12,1,4,1,2,0,2,0,0,0,1,1,1,0,0,3,3,2
4477,Ryan Shannon,SO,2014-15,F,Montana State,Big Sky,3,23,1,4,1,4,0,0,0,0,1,0,1,1,0,0,2,2,2
4478,Nate Sherwood,FR,2014-15,F,Idaho,Big Sky,6,43,1,5,1,4,0,1,0,2,3,7,10,0,1,1,5,10,2
4479,Armand Shoon,SO,2014-15,G,Florida Gulf Coast,A-Sun,11,20,1,4,1,2,0,2,0,0,0,4,4,2,1,0,2,5,2
4480,Antravious Simmons,FR,2014-15,F,Virginia Commonwealth,A-10,3,9,1,1,1,1,0,0,0,0,0,2,2,0,0,0,0,2,2
4481,Anders Skou Hansen,FR,2014-15,G,Niagara,MAAC,15,77,1,7,1,5,0,2,0,0,0,5,5,5,4,0,3,5,2
4482,Ryan Skovranko,FR,2014-15,F,Robert Morris,NEC,1,3,1,1,1,1,0,0,0,0,0,0,0,0,0,0,0,0,2
4483,Dan Studer,JR,2014-15,F,Milwaukee,Horizon,12,45,1,7,1,6,0,1,0,1,4,2,6,3,2,0,4,8,2
4484,Greg Tarca,FR,2014-15,G,Quinnipiac,MAAC,5,5,1,3,1,2,0,1,0,0,0,0,0,0,0,0,0,2,2
4485,Jahmel Taylor,SO,2014-15,G,Washington,Pac-12,2,7,1,2,1,1,0,1,0,0,0,2,2,1,0,0,1,3,2
4486,Kenneth Taylor,SO,2014-15,G,Jackson State,SWAC,8,29,1,5,1,5,0,0,0,0,1,2,3,1,0,0,2,4,2
4487,Sean Tingle,SR,2014-15,F,Arkansas-Pine Bluff,SWAC,3,9,0,5,0,5,0,0,2,4,4,0,4,0,1,1,1,2,2
4488,Stephen Toyra,SO,2014-15,G,Purdue,Big Ten,5,16,0,2,0,1,0,1,2,4,0,2,2,0,0,0,3,1,2
4489,Parker U'u,SO,2014-15,G,San Diego State,MWC,2,8,1,7,1,3,0,4,0,1,3,3,6,0,0,0,1,1,2
4490,Okey Ukah,JR,2014-15,F,Iowa,Big Ten,10,24,1,2,1,2,0,0,0,0,2,5,7,1,2,0,2,3,2
4491,Stephen Walker,FR,2014-15,G,Prairie View,SWAC,7,26,1,2,1,2,0,0,0,0,0,2,2,2,3,0,1,1,2
4492,C.J. Ward,SO,2014-15,G,Maine,AEC,3,12,0,2,0,1,0,1,2,2,0,0,0,1,0,0,0,0,2
4493,Tyler Warford,SO,2014-15,G,Youngstown State,Horizon,4,8,1,2,1,1,0,1,0,2,1,1,2,1,1,1,1,1,2
4494,Cole Welle,FR,2014-15,F,California,Pac-12,6,11,1,6,1,6,0,0,0,0,2,2,4,0,1,0,0,2,2
4495,Mike Wells,FR,2014-15,G,Albany (NY),AEC,7,10,1,2,1,2,0,0,0,0,0,0,0,0,0,0,0,1,2
4496,Bobby Williams,,2014-15,,South Carolina State,MEAC,1,3,1,2,1,2,0,0,0,0,,,1,1,,,,,2
4497,Reece Williams,JR,2014-15,G,Albany (NY),AEC,7,11,0,2,0,1,0,1,2,2,0,2,2,0,0,0,1,3,2
4498,Riyan Williams,JR,2014-15,G,Georgetown,Big East,8,10,0,3,0,2,0,1,2,2,2,1,3,0,0,1,0,1,2
4499,D.J. Wilson,FR,2014-15,F,Michigan,Big Ten,5,24,1,4,1,3,0,1,0,0,1,5,6,0,0,3,1,4,2
4500,Alan Wisniewski,SR,2014-15,F,Penn State,Big Ten,10,18,1,1,1,1,0,0,0,0,2,4,6,0,0,1,0,2,2
4501,Nick Wood,JR,2014-15,G,Tulsa,AAC,4,8,1,4,1,1,0,3,0,0,0,0,0,0,0,0,1,0,2
4502,David Allen,JR,2014-15,G,Georgetown,Big East,10,20,0,2,0,0,0,2,1,3,0,1,1,0,1,0,1,2,1
4503,Rashad Andrews,FR,2014-15,G,Southern,SWAC,4,10,0,2,0,0,0,2,1,3,1,2,3,1,0,0,4,2,1
4504,Angel Aparicio,JR,2014-15,G,Toledo,MAC,11,15,0,4,0,3,0,1,1,2,1,3,4,2,0,0,1,0,1
4505,Tanner Beachnau,SO,2014-15,G,Central Michigan,MAC,6,13,0,4,0,2,0,2,1,2,0,0,0,3,2,0,1,0,1
4506,Lance Brown,JR,2014-15,G,Campbell,Big South,3,19,0,5,0,3,0,2,1,2,3,0,3,2,2,0,3,2,1
4507,Braxston Bunce,JR,2014-15,C,Cornell,Ivy,4,10,0,1,0,1,0,0,1,2,1,1,2,0,0,0,1,0,1
4508,Charlie Byers,SR,2014-15,G,Kennesaw State,A-Sun,5,8,0,0,0,0,0,0,1,2,0,1,1,1,2,0,0,1,1
4509,Justin Coleman,JR,2014-15,G,North Carolina,ACC,10,19,0,6,0,2,0,4,1,2,1,2,3,3,0,0,1,1,1
4510,Jake Dadika,FR,2014-15,G,Rutgers,Big Ten,7,39,0,6,0,4,0,2,1,2,0,1,1,1,1,0,3,4,1
4511,London Dokubo,SR,2014-15,G,Loyola (IL),MVC,18,32,0,3,0,3,0,0,1,2,1,4,5,3,2,0,3,2,1
4512,Justin Dueck,JR,2014-15,F,California-Davis,Big West,5,23,0,1,0,1,0,0,1,4,2,2,4,0,1,2,3,7,1
4513,Joel Engulu,SO,2014-15,G,Texas A&amp;M-Corpus Christi,Southland,1,3,0,1,0,1,0,0,1,2,0,1,1,0,0,0,1,1,1
4514,EJ Floreal,SO,2014-15,G,Kentucky,SEC,13,20,0,1,0,1,0,0,1,2,0,1,1,0,1,0,4,2,1
4515,Daniel Green,SR,2014-15,F,Wake Forest,ACC,4,4,0,0,0,0,0,0,1,2,1,0,1,0,0,0,0,0,1
4516,Austin Hatch,FR,2014-15,G,Michigan,Big Ten,5,5,0,2,0,0,0,2,1,3,0,0,0,0,0,0,1,0,1
4517,Josh Humphrey,SR,2014-15,G-F,Green Bay,Horizon,14,41,0,4,0,4,0,0,1,3,1,4,5,3,0,2,2,7,1
4518,Matthew Jiles,FR,2014-15,G,New Orleans,Southland,10,30,0,7,0,4,0,3,1,2,1,3,4,4,1,0,2,1,1
4519,Jacob Kessler,FR,2014-15,G-F,Army,Patriot,4,15,0,2,0,1,0,1,1,2,2,3,5,2,0,0,1,2,1
4520,Cameron Liss,FR,2014-15,F,Illinois,Big Ten,12,16,0,0,0,0,0,0,1,2,0,3,3,0,0,0,1,1,1
4521,Sam Malone,SR,2014-15,G,Kentucky,SEC,8,11,0,1,0,1,0,0,1,2,1,2,3,0,0,0,1,0,1
4522,Will McQuitter,JR,2014-15,G,Houston Baptist,Southland,2,7,0,1,0,1,0,0,1,2,0,2,2,1,1,0,1,1,1
4523,Shawn Meyer,SR,2014-15,G,Kansas State,Big 12,9,11,0,2,0,2,0,0,1,3,0,1,1,1,1,0,0,2,1
4524,Patrick Onwenu,SR,2014-15,F,Detroit Mercy,Horizon,1,5,0,1,0,1,0,0,1,2,2,0,2,0,0,0,1,1,1
4525,Paddy Quinn,JR,2014-15,G,Columbia,Ivy,8,19,0,1,0,0,0,1,1,2,2,1,3,1,0,0,0,4,1
4526,Troy Rike,FR,2014-15,F,Wake Forest,ACC,4,6,0,1,0,1,0,0,1,2,1,1,2,1,0,0,0,0,1
4527,Schuyler Rimmer,SO,2014-15,C,Stanford,Pac-12,2,6,0,0,0,0,0,0,1,2,1,1,2,0,0,0,0,0,1
4528,Shawn Simmons,FR,2014-15,G,Pennsylvania,Ivy,9,13,0,1,0,1,0,0,1,6,1,2,3,0,0,0,1,1,1
4529,Kendall Smith,SO,2014-15,G,Nevada-Las Vegas,MWC,2,14,0,1,0,1,0,0,1,2,0,1,1,0,0,0,3,0,1
4530,Ayinde Sprewell,JR,2014-15,G,Western Kentucky,CUSA,3,23,0,5,0,5,0,0,1,2,2,3,5,0,1,0,3,2,1
4531,Isaiah Washington,FR,2014-15,G,Penn State,Big Ten,1,3,0,0,0,0,0,0,1,2,0,0,0,0,0,0,0,0,1
4532,Alex Wolf,FR,2014-15,F,Dartmouth,Ivy,4,4,0,0,0,0,0,0,1,2,0,1,1,0,0,0,0,0,1
4533,Michael Adams,JR,2014-15,G,North Carolina-Greensboro,Southern,3,8,0,2,0,1,0,1,0,0,0,2,2,0,0,0,0,1,0
4534,Akoy Agau,SO,2014-15,F,Louisville,ACC,3,11,0,1,0,0,0,1,0,0,0,1,1,0,0,0,1,0,0
4535,Doyin Akintobi-Adeyeye,SO,2014-15,F,Syracuse,ACC,4,5,0,1,0,1,0,0,0,2,1,2,3,0,0,0,2,1,0
4536,Thomas Allshouse,SR,2014-15,F,Delaware,CAA,3,4,0,0,0,0,0,0,0,0,0,1,1,0,0,0,0,0,0
4537,Nnamdi Amilo,JR,2014-15,F,Connecticut,AAC,2,2,0,0,0,0,0,0,0,0,0,0,0,0,0,0,0,0,0
4538,Nick Amor,SO,2014-15,G-F,Indiana State,MVC,8,10,0,0,0,0,0,0,0,0,0,0,0,1,0,0,0,1,0
4539,Trevor Amzmann,SR,2014-15,G,Maryland,Big Ten,2,4,0,0,0,0,0,0,0,0,0,1,1,0,0,0,1,0,0
4540,Dwaun Anderson,JR,2014-15,G,Wagner,NEC,1,6,0,2,0,2,0,0,0,0,0,3,3,0,0,0,0,2,0
4541,Juan Aparicio,JR,2014-15,G,Texas A&amp;M,SEC,1,2,0,3,0,3,0,0,0,0,0,1,1,0,0,1,0,0,0
4542,Isaiah Baker,JR,2014-15,F,Holy Cross,Patriot,6,14,0,3,0,3,0,0,0,0,1,1,2,0,0,0,1,3,0
4543,Nick Banyard,JR,2014-15,F,Illinois State,MVC,1,0,0,0,0,0,0,0,0,0,0,0,0,0,0,0,0,0,0
4544,Spencer Barks,SR,2014-15,F,Maryland,Big Ten,5,8,0,1,0,1,0,0,0,2,0,2,2,0,0,0,0,2,0
4545,Hayden Barnard,FR,2014-15,F,Missouri,SEC,1,1,0,0,0,0,0,0,0,0,0,0,0,0,0,0,0,0,0
4546,Geoffrey Bates,SR,2014-15,G,Colorado,Pac-12,5,3,0,0,0,0,0,0,0,0,0,0,0,0,0,0,0,1,0
4547,Bilal Begic,SO,2014-15,C,Utah State,MWC,1,0,0,0,0,0,0,0,0,0,0,0,0,0,0,0,0,0,0
4548,Neal Beshears,SR,2014-15,F,Purdue,Big Ten,1,0,0,0,0,0,0,0,0,0,0,0,0,0,0,0,0,0,0
4549,Jack Biebel,SO,2014-15,G,Saint Mary's (CA),WCC,9,12,0,0,0,0,0,0,0,0,0,1,1,0,0,0,0,0,0
4550,Emanuel Binyam,SR,2014-15,G,Quinnipiac,MAAC,4,5,0,5,0,4,0,1,0,0,1,1,2,0,0,0,1,0,0
4551,Mike Booth,FR,2014-15,G,Saint Joseph's,A-10,4,8,0,1,0,1,0,0,0,2,1,1,2,0,0,0,0,0,0
4552,Tyus Bowser,SO,2014-15,G,Houston,AAC,1,1,0,0,0,0,0,0,0,0,0,0,0,0,0,0,0,0,0
4553,Brett Brady,JR,2014-15,G,Colorado,Pac-12,6,14,0,1,0,0,0,1,0,0,0,0,0,1,0,0,0,2,0
4554,Tim Branin,FR,2014-15,G,College of Charleston,CAA,2,1,0,0,0,0,0,0,0,1,0,0,0,0,1,0,1,1,0
4555,Justin Brickman,FR,2014-15,G,Bryant,NEC,3,3,0,0,0,0,0,0,0,0,0,1,1,1,0,0,1,0,0
4556,Christopher Brown,FR,2014-15,G,Morgan State,MEAC,1,3,0,0,0,0,0,0,0,0,0,1,1,0,0,0,0,0,0
4557,Terry Brutus,SO,2014-15,F,Mississippi,SEC,2,7,0,0,0,0,0,0,0,0,0,0,0,1,1,0,0,1,0
4558,Joey Burbach,SO,2014-15,G,Rice,CUSA,2,7,0,2,0,1,0,1,0,0,1,0,1,0,0,0,0,0,0
4559,Zach Bush,SO,2014-15,F,Wichita State,MVC,3,11,0,1,0,1,0,0,0,2,0,2,2,1,0,0,0,1,0
4560,Isaiah Butler,SR,2014-15,G,Mississippi State,SEC,9,26,0,1,0,0,0,1,0,0,0,3,3,1,2,0,2,4,0
4561,Chris Campbell,JR,2014-15,G,North Texas,CUSA,7,16,0,2,0,1,0,1,0,0,1,4,5,2,0,0,0,5,0
4562,Galen Campbell,JR,2014-15,G,Tennessee,SEC,2,2,0,0,0,0,0,0,0,0,0,0,0,0,0,0,0,1,0
4563,Ty Cannaday,FR,2014-15,G,Radford,Big South,3,12,0,3,0,1,0,2,0,0,0,1,1,0,0,0,2,2,0
4564,Jaspin Canteen,JR,2014-15,G,Jacksonville,A-Sun,4,6,0,3,0,1,0,2,0,0,0,1,1,0,0,0,0,0,0
4565,Adrian Carrion Armas,FR,2014-15,G,Grand Canyon,WAC,4,9,0,2,0,1,0,1,0,2,0,2,2,0,0,0,1,2,0
4566,KC Caudill,SR,2014-15,C,Boston College,ACC,1,1,0,0,0,0,0,0,0,0,0,0,0,0,0,0,0,0,0
4567,Tyree Chambers,FR,2014-15,G,Providence,Big East,3,5,0,1,0,0,0,1,0,0,0,0,0,0,0,0,0,2,0
4568,Zach Checkal,SO,2014-15,G,North Dakota State,Summit,7,9,0,3,0,2,0,1,0,0,2,2,4,0,0,0,0,2,0
4569,Jamelle Christian,FR,2014-15,G,Delaware State,MEAC,1,0,0,0,0,0,0,0,0,0,1,0,1,0,0,0,0,0,0
4570,LaQuentin Collins,FR,2014-15,G,Southern,SWAC,1,9,0,0,0,0,0,0,0,0,0,0,0,0,0,0,0,0,0
4571,Tom Cotter,FR,2014-15,F,Oakland,Horizon,8,21,0,2,0,2,0,0,0,0,1,1,2,1,0,0,2,4,0
4572,Andrew Crowley,JR,2014-15,G,Hartford,AEC,2,1,0,0,0,0,0,0,0,0,0,0,0,0,0,0,0,0,0
4573,Spenser Dalton,JR,2014-15,G,North Carolina,ACC,2,2,0,0,0,0,0,0,0,0,0,0,0,0,1,0,0,0,0
4574,Blake Danielak,SO,2014-15,F,Drake,MVC,7,23,0,3,0,1,0,2,0,0,1,1,2,0,0,0,0,2,0
4575,Denzel Davis,FR,2014-15,F,Rice,CUSA,2,11,0,1,0,0,0,1,0,0,0,1,1,0,0,0,1,2,0
4576,Luke Davis,SR,2014-15,G,North Carolina,ACC,3,4,0,0,0,0,0,0,0,0,0,0,0,1,0,0,0,1,0
4577,Darius Dawkins,JR,2014-15,F,Jacksonville,A-Sun,1,8,0,2,0,0,0,2,0,0,0,2,2,0,0,0,0,0,0
4578,John Dawson,SO,2014-15,G,Marquette,Big East,1,4,0,1,0,1,0,0,0,0,0,0,0,0,0,0,0,0,0
4579,Samer Dhillon,SO,2014-15,F,Southern California,Pac-12,4,6,0,1,0,1,0,0,0,0,0,0,0,0,0,0,1,0,0
4580,Brooks Doyle,JR,2014-15,G,Georgia Tech,ACC,4,19,0,3,0,1,0,2,0,0,0,1,1,0,0,0,1,2,0
4581,Chase Driscoll,FR,2014-15,G,North Florida,A-Sun,8,13,0,4,0,0,0,4,0,0,0,1,1,0,0,0,0,1,0
4582,Kevin Dunleavy,SR,2014-15,G,Southern Methodist,AAC,7,14,0,3,0,1,0,2,0,1,0,2,2,0,0,0,2,1,0
4583,Josiah Dunn,SO,2014-15,G,Denver,Summit,5,3,0,0,0,0,0,0,0,0,0,2,2,0,0,0,0,0,0
4584,William Dupuy,SO,2014-15,G,Dayton,A-10,5,4,0,0,0,0,0,0,0,0,0,0,0,0,0,0,0,0,0
4585,Kristian Duravcevic,GR,2014-15,F,Iona,MAAC,9,22,0,2,0,2,0,0,0,3,0,1,1,0,2,3,1,4,0
4586,Francis Edosomwan,SR,2014-15,G,East Carolina,AAC,4,7,0,0,0,0,0,0,0,0,0,0,0,0,0,0,0,1,0
4587,Colin Edwards,FR,2014-15,F,Troy,Sun Belt,1,1,0,0,0,0,0,0,0,0,0,0,0,0,0,0,0,0,0
4588,Lexx Edwards,JR,2014-15,G,Florida,SEC,10,24,0,1,0,0,0,1,0,0,0,5,5,1,0,0,0,5,0
4589,Jay Jay Elvir,FR,2014-15,G,Loyola (IL),MVC,1,2,0,1,0,1,0,0,0,0,0,1,1,0,0,0,0,0,0
4590,Jevon Estelle,SR,2014-15,F,Grand Canyon,WAC,8,11,0,0,0,0,0,0,0,0,0,1,1,1,1,0,0,4,0
4591,Niksha Federico,SO,2014-15,F,San Diego State,MWC,5,8,0,4,0,0,0,4,0,0,0,1,1,0,0,1,0,1,0
4592,Bradley Fischer,FR,2014-15,C,Montana State,Big Sky,11,59,0,5,0,5,0,0,0,0,1,8,9,0,0,2,3,19,0
4593,Jon Fleming,SO,2014-15,G,Kent State,MAC,8,15,0,1,0,0,0,1,0,0,0,2,2,2,1,0,2,2,0
4594,Thomas Fleming,SO,2014-15,G,Niagara,MAAC,1,1,0,0,0,0,0,0,0,0,0,0,0,0,0,0,0,0,0
4595,Armon Fletcher,FR,2014-15,G,Southern Illinois,MVC,1,0,0,0,0,0,0,0,0,0,0,0,0,0,0,0,0,0,0
4596,Ian Fox,FR,2014-15,G,Idaho State,Big Sky,3,39,0,14,0,4,0,10,0,0,1,0,1,3,2,0,2,3,0
4597,James Fraschilla,SR,2014-15,G,Oklahoma,Big 12,7,13,0,1,0,0,0,1,0,0,0,0,0,2,0,0,1,1,0
4598,Bobby Frasco,FR,2014-15,G,Buffalo,MAC,9,14,0,4,0,1,0,3,0,0,0,1,1,0,0,0,0,2,0
4599,Konner Frey,SO,2014-15,F,Utah State,MWC,4,10,0,0,0,0,0,0,0,0,1,2,3,0,0,1,0,3,0
4600,Jordan Fuchs,FR,2014-15,F,Indiana,Big Ten,3,8,0,3,0,3,0,0,0,0,3,2,5,0,0,0,0,1,0
4601,Nate Galgalo,SO,2014-15,G,Eastern Washington,Big Sky,5,7,0,2,0,1,0,1,0,0,0,0,0,0,0,0,0,1,0
4602,KJ Garrett,FR,2014-15,G,Washington,Pac-12,5,10,0,1,0,1,0,0,0,3,1,0,1,0,0,1,2,2,0
4603,Gavin Gibson,JR,2014-15,G,Middle Tennessee,CUSA,7,12,0,5,0,1,0,4,0,0,0,0,0,0,1,0,0,1,0
4604,David Goodwater,SR,2014-15,G,Cleveland State,Horizon,2,3,0,0,0,0,0,0,0,0,0,1,1,0,1,0,0,0,0
4605,Dillon Graham,SO,2014-15,G,Florida,SEC,1,3,0,1,0,0,0,1,0,0,0,0,0,0,1,0,0,0,0
4606,Matt Grassi,FR,2014-15,G,Delaware,CAA,3,4,0,0,0,0,0,0,0,0,0,0,0,1,0,0,0,0,0
4607,Anthony Graves,SR,2014-15,G,Florida Atlantic,CUSA,2,4,0,0,0,0,0,0,0,0,1,0,1,0,0,0,0,0,0
4608,Forrest Greenwalt,SO,2014-15,G,San Diego,WCC,2,4,0,0,0,0,0,0,0,0,0,0,0,0,0,0,1,1,0
4609,Joey Gruden,SO,2014-15,G,Dayton,A-10,7,7,0,0,0,0,0,0,0,0,0,0,0,0,0,0,0,0,0
4610,George Gudadze,FR,2014-15,F,Alcorn State,SWAC,6,14,0,2,0,1,0,1,0,4,3,2,5,0,0,0,0,2,0
4611,DouDou Gueye,JR,2014-15,F,South Carolina State,MEAC,1,0,0,0,0,0,0,0,0,0,0,0,0,0,0,1,0,0,0
4612,Wyatt Hagerty,SO,2014-15,C,Colgate,Patriot,4,26,0,4,0,4,0,0,0,1,2,3,5,0,0,0,1,3,0
4613,Nick Haldes,FR,2014-15,G,Dayton,A-10,4,3,0,0,0,0,0,0,0,0,0,0,0,0,0,0,0,0,0
4614,Jared Harper,FR,2014-15,G,Fairfield,MAAC,4,4,0,0,0,0,0,0,0,0,0,0,0,0,1,0,1,0,0
4615,Tim Hasbargen,FR,2014-15,G,Cleveland State,Horizon,4,20,0,1,0,0,0,1,0,0,0,1,1,1,0,0,0,1,0
4616,Tre Hawkins,FR,2014-15,G,Miami (OH),MAC,1,1,0,0,0,0,0,0,0,0,0,0,0,1,1,0,0,0,0
4617,AJ Hedgecock,SO,2014-15,G,Oregon State,Pac-12,4,9,0,1,0,1,0,0,0,0,0,1,1,1,0,0,2,1,0
4618,Max Heller,JR,2014-15,G,Oregon,Pac-12,2,7,0,0,0,0,0,0,0,0,0,0,0,0,0,0,1,1,0
4619,Matt Hill,SO,2014-15,F-C,Fairfield,MAAC,2,1,0,0,0,0,0,0,0,0,0,0,0,0,0,0,0,0,0
4620,Zach Hodskins,FR,2014-15,G,Florida,SEC,4,7,0,2,0,1,0,1,0,0,0,0,0,0,0,0,1,1,0
4621,Marshall Holmes,FR,2014-15,G,Central Florida,AAC,3,2,0,0,0,0,0,0,0,0,0,0,0,0,0,0,0,0,0
4622,Jordan Howard,SO,2014-15,G,Troy,Sun Belt,7,4,0,0,0,0,0,0,0,0,1,1,2,0,0,0,0,0,0
4623,Chris Huey,SR,2014-15,F,Kansas,Big 12,1,1,0,1,0,1,0,0,0,0,0,0,0,0,0,0,0,0,0
4624,Osahen Iduwe,FR,2014-15,C,Georgia,SEC,11,27,0,2,0,2,0,0,0,0,0,1,1,0,2,1,0,4,0
4625,Charlie Inclan,SO,2014-15,G,Presbyterian,Big South,3,5,0,5,0,4,0,1,0,0,0,3,3,1,0,0,1,0,0
4626,Lonnie Jackson,SR,2014-15,G,Boston College,ACC,3,26,0,5,0,0,0,5,0,0,0,2,2,1,2,0,0,5,0
4627,Chris Jayne,SO,2014-15,G,Holy Cross,Patriot,6,11,0,2,0,1,0,1,0,0,0,3,3,1,1,0,1,3,0
4628,Tim Jensen,SR,2014-15,F,Oregon,Pac-12,7,23,0,3,0,3,0,0,0,0,2,3,5,0,0,1,1,3,0
4629,Jake Johnson,JR,2014-15,F,Pepperdine,WCC,10,43,0,1,0,1,0,0,0,1,1,5,6,2,0,2,1,9,0
4630,Jeffery Johnson,SR,2014-15,G,Mississippi State,SEC,6,12,0,1,0,1,0,0,0,0,1,1,2,0,2,0,1,1,0
4631,Carter Josephs,JR,2014-15,G,Vanderbilt,SEC,13,52,0,0,0,0,0,0,0,2,0,5,5,8,0,0,3,7,0
4632,Samir Kalil,JR,2014-15,G,Quinnipiac,MAAC,7,8,0,1,0,0,0,1,0,0,0,0,0,0,0,0,1,0,0
4633,Jackson Kane,JR,2014-15,G,Bradley,MVC,9,11,0,0,0,0,0,0,0,0,1,1,2,2,0,0,0,0,0
4634,Ryan Kapustka,FR,2014-15,G,Michigan,Big Ten,1,1,0,0,0,0,0,0,0,0,0,0,0,0,0,0,0,0,0
4635,Nick Kazemi,JR,2014-15,G,UCLA,Pac-12,12,18,0,2,0,2,0,0,0,0,1,1,2,1,1,0,2,1,0
4636,Ryan Kelley,SO,2014-15,F,Siena,MAAC,5,5,0,0,0,0,0,0,0,0,0,1,1,0,0,0,0,0,0
4637,Sean Kelly,SR,2014-15,G,Duke,ACC,10,12,0,1,0,0,0,1,0,0,0,0,0,2,0,0,0,0,0
4638,J.C. Kennedy,FR,2014-15,F-G,Weber State,Big Sky,1,3,0,1,0,0,0,1,0,0,0,0,0,0,0,0,0,0,0
4639,Joe Kirby,FR,2014-15,G,Richmond,A-10,3,6,0,2,0,0,0,2,0,0,0,1,1,2,0,1,0,0,0
4640,Robert Knar,FR,2014-15,G,Northern Iowa,MVC,12,17,0,1,0,1,0,0,0,0,1,0,1,0,0,0,0,1,0
4641,Dusan Langura,SO,2014-15,G,Georgia,SEC,5,3,0,3,0,1,0,2,0,0,0,0,0,0,0,0,0,0,0
4642,Aaron Law,JR,2014-15,G,Coastal Carolina,Big South,6,32,0,3,0,2,0,1,0,0,2,6,8,7,4,0,2,3,0
4643,Stephen Leazer,FR,2014-15,G,Saint Louis,A-10,1,1,0,0,0,0,0,0,0,0,0,0,0,0,0,0,0,0,0
4644,Matt LeBato,SR,2014-15,F,Northwestern State,Southland,5,19,0,9,0,3,0,6,0,0,1,4,5,0,1,0,0,4,0
4645,Austin Lee,FR,2014-15,G,Northern Arizona,Big Sky,3,4,0,0,0,0,0,0,0,0,0,1,1,0,0,0,3,0,0
4646,Pat Lenehan,SR,2014-15,G,Connecticut,AAC,6,7,0,1,0,1,0,0,0,0,0,2,2,0,0,1,0,1,0
4647,Brendan Leonard,FR,2014-15,C,Air Force,MWC,2,5,0,0,0,0,0,0,0,0,0,0,0,2,0,0,0,0,0
4648,Andrew Leone,SO,2014-15,G,Fairfield,MAAC,3,2,0,1,0,0,0,1,0,0,0,0,0,0,0,0,1,0,0
4649,David Lipscomb,SO,2014-15,G,St. John's (NY),Big East,13,15,0,1,0,1,0,0,0,0,0,4,4,2,0,0,1,1,0
4650,Sean Locke,SO,2014-15,G,Delaware,CAA,5,5,0,0,0,0,0,0,0,0,0,1,1,1,0,0,0,0,0
4651,Nick Loew,FR,2014-15,F,San Francisco,WCC,6,11,0,2,0,2,0,0,0,1,2,2,4,0,0,0,1,5,0
4652,Jake Lohrbach,SR,2014-15,F,Ohio State,Big Ten,8,13,0,1,0,1,0,0,0,0,0,0,0,0,1,0,2,2,0
4653,Brian Long,SR,2014-15,G,Kentucky,SEC,10,16,0,2,0,0,0,2,0,0,0,0,0,0,1,0,0,2,0
4654,Mike Lopez,FR,2014-15,G,Texas-Pan American,WAC,2,5,0,3,0,1,0,2,0,0,0,0,0,1,0,0,0,1,0
4655,Lionel Love,FR,2014-15,G,Alabama-Birmingham,CUSA,7,9,0,0,0,0,0,0,0,0,0,1,1,0,0,0,0,1,0
4656,Mike Lukashewich,FR,2014-15,G,Minnesota,Big Ten,3,9,0,0,0,0,0,0,0,0,0,0,0,0,0,1,1,0,0
4657,Matthew Mache,JR,2014-15,F,Marquette,Big East,3,3,0,0,0,0,0,0,0,0,0,0,0,0,0,0,0,0,0
4658,Braiten Madrigal,FR,2014-15,G,Boston University,Patriot,4,8,0,2,0,0,0,2,0,0,0,0,0,0,1,0,0,0,0
4659,Cameron Maes,FR,2014-15,G,Missouri State,MVC,2,10,0,3,0,1,0,2,0,0,0,2,2,3,0,0,1,1,0
4660,Karandeep Malhi,FR,2014-15,G,Savannah State,MEAC,1,1,0,1,0,0,0,1,0,0,0,0,0,0,0,0,0,0,0
4661,Stefano Mancini,JR,2014-15,G,Loyola (MD),Patriot,10,30,0,6,0,3,0,3,0,0,0,1,1,0,1,0,2,2,0
4662,Jaiquan Manning,FR,2014-15,G,Maryland-Eastern Shore,MEAC,1,0,0,0,0,0,0,0,0,0,0,0,0,0,0,0,0,0,0
4663,Matt Massimino,SO,2014-15,G,Fordham,A-10,10,12,0,3,0,3,0,0,0,0,1,0,1,0,0,0,1,1,0
4664,DeVante Mayes,FR,2014-15,G,Western Illinois,Summit,6,12,0,1,0,1,0,0,0,0,0,1,1,1,0,0,0,3,0
4665,Phillip McGloin,FR,2014-15,G,Vanderbilt,SEC,5,5,0,1,0,0,0,1,0,0,0,3,3,1,0,0,3,0,0
4666,Geremy McKay,FR,2014-15,F,Albany (NY),AEC,1,1,0,1,0,1,0,0,0,0,0,1,1,0,0,0,0,0,0
4667,Jon McKeeman,JR,2014-15,G,Purdue,Big Ten,5,12,0,1,0,1,0,0,0,0,0,0,0,0,0,0,1,1,0
4668,Curtis McRoy,SO,2014-15,G,Delaware,CAA,4,5,0,0,0,0,0,0,0,0,0,0,0,0,0,0,0,0,0
4669,Drew Mellon,SR,2014-15,F,Arizona,Pac-12,12,23,0,7,0,4,0,3,0,0,1,2,3,2,0,0,0,1,0
4670,Christopher Miller,SO,2014-15,G,Northern Arizona,Big Sky,4,16,0,3,0,3,0,0,0,0,0,1,1,2,0,0,2,2,0
4671,Dominique Miller,JR,2014-15,F,Jacksonville State,OVC,1,1,0,0,0,0,0,0,0,0,0,0,0,0,0,0,0,0,0
4672,Leland Miller,JR,2014-15,C,Utah Valley,WAC,2,5,0,0,0,0,0,0,0,0,0,0,0,0,0,0,0,1,0
4673,Andrew Mitchell,SR,2014-15,G,Xavier,Big East,3,4,0,0,0,0,0,0,0,0,0,1,1,0,0,0,0,0,0
4674,Justice Montgomery,SO,2014-15,G,American,Patriot,11,15,0,0,0,0,0,0,0,1,1,0,1,1,0,0,0,4,0
4675,Kevin Montminy,SR,2014-15,G,Penn State,Big Ten,5,6,0,2,0,2,0,0,0,2,1,0,1,0,0,0,0,0,0
4676,John Moran,JR,2014-15,G,Richmond,A-10,3,5,0,0,0,0,0,0,0,0,0,0,0,1,0,0,0,1,0
4677,Nick Moschetti,FR,2014-15,G,IPFW,Summit,5,7,0,1,0,0,0,1,0,0,0,0,0,0,1,0,1,0,0
4678,John Mosser,FR,2014-15,G,Mercer,Southern,1,3,0,1,0,0,0,1,0,0,1,0,1,1,0,0,0,0,0
4679,Trey Mourning,FR,2014-15,F,Georgetown,Big East,6,12,0,4,0,1,0,3,0,0,1,1,2,3,0,0,1,3,0
4680,Djordjije Mumin,FR,2014-15,G,Central Florida,AAC,5,6,0,2,0,0,0,2,0,0,0,0,0,0,0,0,0,0,0
4681,Corban Murphy,SO,2014-15,G,Arizona State,Pac-12,3,3,0,1,0,0,0,1,0,0,0,0,0,1,0,0,0,0,0
4682,Nihad Musovic,SR,2014-15,G,Fordham,A-10,6,5,0,0,0,0,0,0,0,0,0,0,0,0,0,0,0,1,0
4683,Haboubacar Mutombo,FR,2014-15,G,Western Carolina,Southern,2,8,0,1,0,1,0,0,0,0,3,1,4,0,1,0,1,1,0
4684,Khadim Ndiaye,SR,2014-15,F,St. John's (NY),Big East,11,14,0,1,0,1,0,0,0,0,0,0,0,0,0,0,0,1,0
4685,Langdon Neal,SO,2014-15,G,American,Patriot,5,3,0,0,0,0,0,0,0,0,0,0,0,0,1,0,0,4,0
4686,Alex Nesbitt,SR,2014-15,G,Harvard,Ivy,3,9,0,0,0,0,0,0,0,0,0,0,0,0,0,0,1,0,0
4687,Ike Ngwudo,SO,2014-15,F,Dartmouth,Ivy,12,33,0,4,0,2,0,2,0,2,1,6,7,2,0,1,1,7,0
4688,Doug Niedrich,SR,2014-15,F,Wake Forest,ACC,7,8,0,6,0,6,0,0,0,0,2,2,4,0,0,0,0,0,0
4689,Mark Noble,SO,2014-15,G,Akron,MAC,6,12,0,4,0,3,0,1,0,1,2,1,3,0,1,0,0,3,0
4690,Charlie Noebel,SO,2014-15,G,Oregon,Pac-12,4,6,0,1,0,0,0,1,0,0,0,1,1,0,0,0,2,1,0
4691,Josh Olabosipo,SO,2014-15,F,Maryland-Baltimore County,AEC,4,3,0,0,0,0,0,0,0,0,0,0,0,0,0,0,0,0,0
4692,Opeyemi Olomo,SR,2014-15,G,St. Bonaventure,A-10,2,1,0,2,0,0,0,2,0,0,0,0,0,0,0,0,1,0,0
4693,Laquarious Paige,FR,2014-15,G,Indiana State,MVC,4,41,0,2,0,1,0,1,0,1,1,1,2,2,2,0,8,5,0
4694,Mark Parisi,FR,2014-15,G,Long Island University,NEC,2,4,0,0,0,0,0,0,0,0,0,1,1,0,0,0,0,0,0
4695,Deryk Pearsall,SO,2014-15,F,Montana State,Big Sky,1,0,0,0,0,0,0,0,0,0,0,0,0,0,0,0,0,0,0
4696,Aaron Peek,SR,2014-15,F,Georgia Tech,ACC,2,4,0,0,0,0,0,0,0,0,0,0,0,0,0,0,1,0,0
4697,Nick Pellar,SO,2014-15,F,Florida Gulf Coast,A-Sun,8,8,0,0,0,0,0,0,0,0,0,1,1,1,1,0,1,0,0
4698,Paul Perez,FR,2014-15,G,Texas A&amp;M-Corpus Christi,Southland,1,3,0,1,0,0,0,1,0,0,0,0,0,0,0,0,0,1,0
4699,Michael Pickney,FR,2014-15,G,Georgia State,Sun Belt,1,0,0,1,0,1,0,0,0,0,0,1,1,0,0,0,1,1,0
4700,Josh Pierre,JR,2014-15,G,Arkansas State,Sun Belt,8,22,0,2,0,0,0,2,0,0,0,3,3,0,1,0,1,0,0
4701,Anthony Piganelli,SR,2014-15,G,Oregon,Pac-12,4,6,0,1,0,1,0,0,0,0,0,0,0,0,0,0,0,1,0
4702,Daniel Pillari,FR,2014-15,G,Monmouth,MAAC,12,10,0,3,0,1,0,2,0,0,0,0,0,1,0,0,0,2,0
4703,Shane Plunkett,JR,2014-15,G,Rhode Island,A-10,4,5,0,1,0,0,0,1,0,0,0,0,0,1,0,0,0,1,0
4704,Jordan Reed,FR,2014-15,G,Rice,CUSA,12,64,0,11,0,1,0,10,0,0,5,8,13,3,2,0,4,8,0
4705,Josh Repine,FR,2014-15,G,Colorado,Pac-12,4,4,0,0,0,0,0,0,0,0,0,0,0,0,0,0,0,1,0
4706,Antonio Robinson,SR,2014-15,G,Louisiana State,SEC,1,4,0,0,0,0,0,0,0,0,0,1,1,0,0,0,1,0,0
4707,Kam Rowan,FR,2014-15,G,Western Illinois,Summit,4,5,0,0,0,0,0,0,0,0,0,0,0,0,1,0,1,1,0
4708,Rand Rowland,SO,2014-15,F,Georgia Tech,ACC,1,2,0,0,0,0,0,0,0,0,0,0,0,0,0,0,0,1,0
4709,Jon Rubenstein,FR,2014-15,G,Michigan,Big Ten,1,1,0,0,0,0,0,0,0,1,0,0,0,0,0,0,0,0,0
4710,Zach Rumph,FR,2014-15,G,Southeastern Louisiana,Southland,12,46,0,3,0,2,0,1,0,0,0,5,5,3,2,0,6,6,0
4711,Ryan Schmidt,SR,2014-15,G,Illinois,Big Ten,4,2,0,0,0,0,0,0,0,0,0,0,0,0,0,0,0,0,0
4712,Tanner Schmidt,JR,2014-15,F,Northern Colorado,Big Sky,1,2,0,0,0,0,0,0,0,0,0,0,0,0,0,0,0,0,0
4713,Mason Schoen,FR,2014-15,G,Kansas State,Big 12,10,9,0,2,0,0,0,2,0,0,2,0,2,0,0,0,0,0,0
4714,Trey Scott,FR,2014-15,G,Alabama State,SWAC,3,4,0,0,0,0,0,0,0,0,0,1,1,0,0,0,1,0,0
4715,Greg Sequele,SR,2014-15,F,DePaul,Big East,5,22,0,2,0,2,0,0,0,2,3,1,4,0,1,0,2,7,0
4716,Jordan Shea,FR,2014-15,G,Massachusetts-Lowell,AEC,1,0,0,0,0,0,0,0,0,0,0,0,0,0,0,0,0,1,0
4717,Darius Sizemore,FR,2014-15,G,Alabama State,SWAC,1,0,0,1,0,1,0,0,0,0,0,0,0,0,0,0,0,0,0
4718,Gerald Smith,FR,2014-15,G,Samford,Southern,3,15,0,4,0,2,0,2,0,0,0,1,1,2,0,0,1,1,0
4719,Jordan Smith,JR,2014-15,G,Wisconsin,Big Ten,14,35,0,9,0,4,0,5,0,0,1,1,2,0,0,0,0,3,0
4720,Carlton Speight,FR,2014-15,G,Louisiana State,SEC,1,4,0,1,0,1,0,0,0,0,0,0,0,1,0,0,0,0,0
4721,Patrick Speller,FR,2014-15,G,Howard,MEAC,2,2,0,0,0,0,0,0,0,0,0,0,0,0,0,0,0,0,0
4722,Tim Stainbrook,SO,2014-15,F,Xavier,Big East,4,5,0,1,0,1,0,0,0,0,1,0,1,0,0,0,0,1,0
4723,Ryan Staten,SR,2014-15,G,San Diego State,MWC,6,11,0,5,0,3,0,2,0,0,0,1,1,2,0,1,0,0,0
4724,Daniel Stensland,FR,2014-15,G,Iowa State,Big 12,4,8,0,0,0,0,0,0,0,0,0,1,1,1,0,0,0,0,0
4725,Conrad Stephens,SO,2014-15,F,Robert Morris,NEC,4,5,0,2,0,1,0,1,0,0,0,0,0,1,0,0,0,1,0
4726,Chris Stowell,FR,2014-15,F,Miami (FL),ACC,4,6,0,1,0,1,0,0,0,0,0,0,0,1,0,0,0,1,0
4727,Jamaree Strickland,FR,2014-15,C,Cincinnati,AAC,1,0,0,0,0,0,0,0,0,0,0,0,0,0,0,0,0,0,0
4728,Jacob Susskind,SR,2014-15,G,Maryland,Big Ten,3,5,0,1,0,1,0,0,0,0,0,0,0,0,0,0,1,0,0
4729,Mike Sutton,FR,2014-15,G,Syracuse,ACC,4,5,0,1,0,0,0,1,0,0,0,0,0,0,0,1,0,0,0
4730,Jeremiah Tate,SO,2014-15,G,Wofford,Southern,3,7,0,0,0,0,0,0,0,2,0,0,0,0,0,0,0,0,0
4731,Rory Temkin,SR,2014-15,G,Rhode Island,A-10,2,2,0,0,0,0,0,0,0,0,0,0,0,0,0,0,0,0,0
4732,Chandler Thomas,SR,2014-15,F-G,Ohio,MAC,3,4,0,3,0,2,0,1,0,0,1,0,1,0,0,0,1,0,0
4733,Zaire Thompson,FR,2014-15,G,Fordham,A-10,9,23,0,0,0,0,0,0,0,0,1,3,4,2,3,0,3,7,0
4734,Corey Tobin,FR,2014-15,G,Georgia State,Sun Belt,8,13,0,0,0,0,0,0,0,0,1,2,3,0,0,0,0,1,0
4735,Zach Turcotte,SO,2014-15,F,Massachusetts,A-10,1,1,0,0,0,0,0,0,0,0,0,0,0,1,0,0,0,0,0
4736,Jordan Tyson,FR,2014-15,F,St. Bonaventure,A-10,1,1,0,0,0,0,0,0,0,0,0,0,0,0,0,0,0,0,0
4737,Ryan Van Pelt,FR,2014-15,F-C,Weber State,Big Sky,2,6,0,0,0,0,0,0,0,0,0,0,0,1,1,0,1,2,0
4738,David Varoli,SO,2014-15,G,Niagara,MAAC,1,1,0,1,0,0,0,1,0,0,0,0,0,0,0,0,0,0,0
4739,Anthony Vernon,FR,2014-15,F,Morgan State,MEAC,4,7,0,1,0,1,0,0,0,0,0,0,0,0,0,0,1,1,0
4740,Kenneth Wachira,SO,2014-15,F,Jackson State,SWAC,4,6,0,0,0,0,0,0,0,0,0,0,0,0,0,0,0,0,0
4741,Eric Wagenlander,SO,2014-15,G,Wofford,Southern,3,6,0,1,0,0,0,1,0,0,0,1,1,0,0,0,1,0,0
4742,Travis Waldroup-Rodriguez,FR,2014-15,G-F,Army,Patriot,1,4,0,0,0,0,0,0,0,0,0,0,0,0,0,0,0,0,0
4743,Corey Walker,SR,2014-15,G,Cal State Fullerton,Big West,7,19,0,2,0,1,0,1,0,0,0,2,2,0,0,0,2,3,0
4744,Dee Wallace,SR,2014-15,G,Cal State Bakersfield,WAC,6,14,0,4,0,0,0,4,0,0,0,2,2,0,0,0,0,1,0
4745,Mitch Warner,JR,2014-15,G,Charlotte,CUSA,3,2,0,2,0,2,0,0,0,0,0,0,0,0,0,0,0,0,0
4746,Nathan Watkins,JR,2014-15,G,Vanderbilt,SEC,12,18,0,2,0,0,0,2,0,0,0,1,1,0,0,0,1,2,0
4747,Austin Weiher,FR,2014-15,F,Southern Illinois,MVC,1,0,0,0,0,0,0,0,0,0,0,0,0,0,0,0,0,0,0
4748,Ramon White,JR,2014-15,G,Texas A&amp;M,SEC,1,1,0,0,0,0,0,0,0,0,0,0,0,0,0,0,0,0,0
4749,Stilman White,SO,2014-15,G,North Carolina,ACC,9,23,0,1,0,0,0,1,0,0,1,0,1,3,0,0,0,2,0
4750,Ellis Williams,SO,2014-15,F,Bryant,NEC,7,18,0,1,0,1,0,0,0,0,0,2,2,1,2,0,2,5,0
4751,Reggie Williams,FR,2014-15,G,Ohio,MAC,7,12,0,1,0,1,0,0,0,2,0,0,0,1,0,0,0,1,0
4752,Terry Winn,FR,2014-15,F,Texas-El Paso,CUSA,1,2,0,0,0,0,0,0,0,0,0,0,0,0,0,0,0,1,0
4753,Brian Wright,FR,2014-15,G,California-Riverside,Big West,9,22,0,1,0,0,0,1,0,0,0,1,1,1,0,1,1,3,0
4754,Alec Wulff,FR,2014-15,G,UCLA,Pac-12,4,5,0,1,0,0,0,1,0,0,0,0,0,1,1,0,0,0,0
4755,John Yi,FR,2014-15,G,Pepperdine,WCC,5,4,0,1,0,1,0,0,0,0,0,0,0,0,0,0,2,0,0
4756,Brandon Young,FR,2014-15,G,Georgia,SEC,7,5,0,2,0,1,0,1,0,0,0,1,1,0,0,0,0,0,0
4757,Stephen Zurich,JR,2014-15,F,Rutgers,Big Ten,8,29,0,1,0,1,0,0,0,2,0,2,2,1,0,1,2,4,0
